character,script_line,episode,begin,end,duration,episode_index,bad_words,is_male
Aureliano Adami,porca di quella puttana ma ce li hai gli occhi,1,2348000000,2371200000,23200000,25,1,1
Aureliano Adami,lo vedi o no la gente che locali vuole frequentare,1,2377600000,2399200000,21600000,26,0,1
Aureliano Adami,su quel chiosco ci butti due spicci e si riempie,1,2400000000,2424400000,24400000,27,0,1
Aureliano Adami,un certo tipo di clientela oltre a mangiare e bere vuole pippare,1,2425200000,2452400000,27200000,28,0,1
Aureliano Adami,quel posto non è tuo era di mamma,1,2496400000,2512800000,16400000,30,0,1
Aureliano Adami,oh che,1,2524800000,2547200000,22400000,32,0,1
Livia Adami,papà,1,2562000000,2570400000,8400000,35,0,0
Livia Adami,pure te non insistere no lo sai che gli dà fastidio,1,2649600000,2675200000,25600000,37,0,0
Aureliano Adami,lasciami perdere,1,2676000000,2689200000,13200000,38,0,1
Aureliano Adami,zingaro ti devo dire una cosa,1,3028000000,3049200000,21200000,42,0,1
Aureliano Adami,scusate,1,3050000000,3060000000,10000000,44,0,1
Aureliano Adami,volevo dirti che sei un pezzo di merda,1,3060800000,3076400000,15600000,45,1,1
Aureliano Adami,fate stare zitto sto cazzo di cane e sto parassita buttatelo a mare,1,3132800000,3171200000,38400000,48,1,1
Gabriele Marchilli,non ci posso credere guarda chi ci sta,1,3312400000,3350800000,38400000,50,0,1
Gabriele Marchilli,sì che ti serve,1,3627600000,3656800000,29200000,56,0,1
Gabriele Marchilli,come 20 000 euro,1,4304000000,4318800000,14800000,71,0,1
Gabriele Marchilli,avrò venduto cinque piotte di pasticche che siete matti,1,4319600000,4346000000,26400000,72,0,1
Gabriele Marchilli,sì,1,4446000000,4454800000,8800000,77,0,1
Manfredi Anacleti,adesso sei tu lo sposo,1,4804000000,4822800000,18800000,81,0,1
Manfredi Anacleti,onora il cognome che porti e le nostre tradizioni,1,4828400000,4861600000,33200000,82,0,1
Manfredi Anacleti,avanti,1,4883200000,4894800000,11600000,83,0,1
Manfredi Anacleti,avanti spadi,1,4903600000,4918400000,14800000,84,0,1
Manfredi Anacleti,avanti,1,4928800000,4938000000,9200000,85,0,1
Manfredi Anacleti,avanti spadi,1,4957200000,4971200000,14000000,86,0,1
Manfredi Anacleti,ammazza sta bestia spadi,1,5004800000,5025200000,20400000,87,0,1
Manfredi Anacleti,avanti levati,1,5050400000,5068800000,18400000,88,0,1
Manfredi Anacleti,ammazzala,1,5091600000,5100800000,9200000,89,0,1
Manfredi Anacleti,ammazzala spadi ammazzala,1,5125599999,5152400000,26800001,90,0,1
Manfredi Anacleti,fa l uomo,1,5167600000,5187999999,20399999,91,0,1
Manfredi Anacleti,ammazzala,1,5199199999,5212400000,13200001,92,0,1
Manfredi Anacleti,ci voleva tanto,1,5312800000,5332000000,19200000,94,0,1
Alberto Anacleti,è che non mi volevo sporcare,1,5332800000,5354000000,21200000,95,0,1
Manfredi Anacleti,mo puoi conoscere la sposa,1,5414800000,5433200000,18400000,97,0,1
Samurai Valerio,quindi,1,5585200000,5594000000,8800000,102,0,1
Samurai Valerio,ti pago per risolvere i problemi,1,5669600000,5698000000,28400000,106,0,1
Samurai Valerio,chi,1,5844000000,5862800000,18800000,112,0,1
Samurai Valerio,che c è,1,5983600000,6006400000,22800000,117,0,1
Samurai Valerio,va bene france mi pare che si è scaricato,1,6032400000,6056400000,24000000,119,0,1
Sara Monaschi,d accordo,1,6204800000,6214800000,10000000,125,0,0
Sara Monaschi,la commissione è spaccata e l altro consorzio è in mano alla maggioranza,1,6218800000,6252800000,34000000,126,0,0
Sara Monaschi,arrivo,1,6253600000,6271200000,17600000,128,0,0
Sara Monaschi,quello che conta è il voto del monsignor theodosiou,1,6274800000,6298400000,23600000,129,0,0
Sara Monaschi,sono mesi che ci lavoro,1,6299200000,6312800000,13600000,130,0,0
Sara Monaschi,va bene oggi lo inchioderò,1,6331600000,6348800000,17200000,131,0,0
Sara Monaschi,la richiamo dopo,1,6361200000,6372800000,11600000,132,0,0
Sara Monaschi,hanno 20 giorni per chiudere tutto e per decidere chi costruisce e dove,1,6514800000,6549200000,34400000,137,0,0
Sara Monaschi,sì ma a questo punto anche loro,1,6640000000,6658800000,18800000,141,0,0
Sara Monaschi,tra i bilanci in rosso e i vescovi sotto processo in america,1,6666400000,6696800000,30400000,142,0,0
Sara Monaschi,hanno bisogno di soldi devono vendere,1,6702400000,6727200000,24800000,143,0,0
Sara Monaschi,chi viene oggi dal papa,1,6739600000,6769200000,29600000,144,0,0
Sara Monaschi,e allora sarà una cosa lunga,1,6770000000,6787200000,17200000,146,0,0
Sara Monaschi,scappo,1,6847200000,6856000000,8800000,148,0,0
Sara Monaschi,tranquillo,1,6869600000,6880000000,10400000,149,0,0
Amedeo Cinaglia,ho sempre preso parecchi voti,1,7050800000,7083200000,32400000,154,0,1
Amedeo Cinaglia,fortunatamente questo non la riguarda no finucci,1,7162400000,7189600000,27200000,159,0,1
Amedeo Cinaglia,arrivederci,1,7369200000,7378000000,8800000,166,0,1
Manfredi Anacleti,hai finito spadi eh,1,7832000000,7857200000,25200000,173,0,1
Alberto Anacleti,che vuoi,1,7876800000,7899600000,22800000,174,0,1
Manfredi Anacleti,va con lui,1,7876800000,7899600000,22800000,175,0,1
Alberto Anacleti,dove,1,7908800000,7932000000,23200000,176,0,1
Manfredi Anacleti,vai con lui,1,7908800000,7932000000,23200000,177,0,1
Manfredi Anacleti,che c è,1,7996000000,8011600000,15600000,178,0,1
Manfredi Anacleti,vai,1,8160000000,8168800000,8800000,180,0,1
Manfredi Anacleti,improvvisatona eh,1,8178400000,8194800000,16400000,181,0,1
Manfredi Anacleti,entra oggi è un giorno di festa,1,8229200000,8243200000,14000000,182,0,1
Manfredi Anacleti,vieni a prendere un caffè mio fratello si fidanza,1,8244000000,8265600000,21600000,183,0,1
Samurai Valerio,stiamo bene qua,1,8266400000,8274800000,8400000,184,0,1
Samurai Valerio,non sono venuto per gli auguri,1,8281200000,8297200000,16000000,185,0,1
Samurai Valerio,hai mandato un coglione a rompere il cazzo a un locale degli adami ieri sera eh,1,8306800000,8343600000,36800000,186,1,1
Samurai Valerio,che c è ti vuoi allargare,1,8355200000,8372800000,17600000,187,0,1
Manfredi Anacleti,mica sono zone tue,1,8373600000,8393600000,20000000,188,0,1
Samurai Valerio,tutta roma è zona mia,1,8394400000,8410400000,16000000,189,0,1
Manfredi Anacleti,boris è un pischello stava lì per divertirsi,1,8439200000,8463600000,24400000,190,0,1
Manfredi Anacleti,sono sti cazzo di adami che hanno il minimo alto,1,8464400000,8489200000,24800000,191,1,1
Manfredi Anacleti,vai a domandare a loro come sono andate le cose,1,8490000000,8512000000,22000000,192,0,1
Samurai Valerio,forse tu non capisci bene l italiano,1,8517600000,8536000000,18400000,193,0,1
Samurai Valerio,io il sinti non lo parlo e neanche m interessa di impararlo,1,8541200000,8571200000,30000000,194,0,1
Samurai Valerio,è la prima e l ultima volta che vengo in questo posto di merda a dirtelo,1,8581600000,8621200000,39600000,195,1,1
Samurai Valerio,attento a fare scoppiare la guerra la perdi,1,8622000000,8653600000,31600000,196,0,1
Samurai Valerio,e lo sai,1,8661200000,8672000000,10800000,197,0,1
Manfredi Anacleti,sì ma l offesa a mio cugino rimane e quello bisogna calmarlo che dici,1,8677600000,8716800000,39200000,198,0,1
Samurai Valerio,vedo che sei svelto a capire,1,8730400000,8746000000,15600000,199,0,1
Samurai Valerio,quanto ti devono dare per chiudere sta storia,1,8763600000,8784000000,20400000,200,0,1
Sara Monaschi,eminenza la nostra situazione di bilancio è molto critica,1,9288000000,9318400000,30400000,213,0,0
Sara Monaschi,ma condivido le preoccupazioni di monsignor theodosiou,1,9319200000,9349600000,30400000,214,0,0
Sara Monaschi,monsignore mi scusi,1,9606000000,9621200000,15200000,219,0,0
Sara Monaschi,penso sia il caso che la pausa che ha chiesto non sia troppo lunga,1,9626800000,9662800000,36000000,220,0,0
Sara Monaschi,il sindaco si è appena dimesso e,1,9673600000,9696800000,23200000,221,0,0
Sara Monaschi,certo,1,9819200000,9829200000,10000000,226,0,0
Sara Monaschi,magari,1,9853600000,9864400000,10800000,227,0,0
Sara Monaschi,una di quelle,1,9869200000,9880400000,11200000,228,0,0
Sara Monaschi,serate senza pensieri può aiutarla a velocizzare queste pratiche,1,9886800000,9924800000,38000000,229,0,0
Sara Monaschi,stasera,1,10059200000,10072800000,13600000,231,0,0
Sara Monaschi,perché no,1,10083600000,10094400000,10800000,232,0,0
Sara Monaschi,ci penso io,1,10142400000,10153600000,11200000,234,0,0
Aureliano Adami,hai messo lo zucchero,1,10382400000,10398399999,15999999,236,0,1
Livia Adami,sì,1,10382400000,10398399999,15999999,237,0,0
Aureliano Adami,hai visto tuo padre sì,1,10424400000,10440000000,15600000,238,0,1
Aureliano Adami,lo schiavo del samurai,1,10451600000,10465999999,14399999,239,0,1
Livia Adami,almeno è schiavo di uno potente,1,10466800000,10485600000,18800000,240,0,0
Aureliano Adami,niente che ho fatto,1,10522000000,10546800000,24800000,242,0,1
Aureliano Adami,mo te li dice samurai i cazzi di tuo figlio,1,10547600000,10569200000,21600000,244,1,1
Livia Adami,stavano in un locale nostro papà,1,10596400000,10619200000,22800000,246,0,0
Aureliano Adami,ecco,1,10596400000,10619200000,22800000,247,0,1
Aureliano Adami,mo ha capito che non lo può fare,1,10620000000,10648000000,28000000,248,0,1
Aureliano Adami,ma stai zitto il samurai parla e tu apri la bocca sei un pupazzo,1,10700000000,10730400000,30400000,252,0,1
Livia Adami,stai buono,1,10731200000,10746400000,15200000,254,0,0
Livia Adami,vai di là per favore,1,10747200000,10759600000,12400000,255,0,0
Livia Adami,stai calmo,1,10760400000,10774400000,14000000,256,0,0
Gabriele Marchilli,papà hai fatto colazione,1,11246000000,11275600000,29600000,272,0,1
Gabriele Marchilli,niente dai fammi andare che è tardi,1,11276400000,11296400000,20000000,274,0,1
Gabriele Marchilli,no niente pa,1,11370400000,11380400000,10000000,277,0,1
Gabriele Marchilli,no tranquillo,1,11381200000,11406800000,25600000,279,0,1
Gabriele Marchilli,sì,1,11466400000,11474800000,8400000,282,0,1
Gabriele Marchilli,scusa sto in ritardo,1,11475600000,11490000000,14400000,283,0,1
Gabriele Marchilli,ciao,1,11536000000,11544400000,8400000,285,0,1
Gabriele Marchilli,sì,1,11655200000,11663600000,8400000,287,0,1
Gabriele Marchilli,mi devi aiutare marco,1,11668800000,11681200000,12400000,288,0,1
Gabriele Marchilli,ho fatto un casino ho fatto incazzare uno grosso e gli devo dare 20 000 euro,1,11688400000,11725600000,37200000,289,1,1
Gabriele Marchilli,oggi ti prego,1,11731600000,11744800000,13200000,290,0,1
Gabriele Marchilli,marco,1,11776800000,11788000000,11200000,291,0,1
Gabriele Marchilli,cazzo,1,11803600000,11817600000,14000000,292,1,1
Gabriele Marchilli,fanculo,1,11828000000,11842400000,14400000,293,1,1
Gabriele Marchilli,ehi sara,1,12054800000,12065600000,10800000,295,0,1
Gabriele Marchilli,come stai,1,12071200000,12080000000,8800000,296,0,1
Gabriele Marchilli,ehm,1,12116000000,12125600000,9600000,297,0,1
Gabriele Marchilli,oggi sto un po incasinato però,1,12134400000,12150400000,16000000,298,0,1
Gabriele Marchilli,però dai ce la potrei fare,1,12159600000,12171200000,11600000,299,0,1
Gabriele Marchilli,dove ci vediamo,1,12202400000,12215600000,13200000,300,0,1
Gabriele Marchilli,ok a dopo,1,12240000000,12259200000,19200000,301,0,1
Gabriele Marchilli,ciao,1,12268400000,12278800000,10400000,302,0,1
Samurai Valerio,presidente cinaglia,1,12463600000,12477600000,14000000,303,0,1
Samurai Valerio,avrei bisogno di un minuto del suo tempo,1,12516000000,12536000000,20000000,304,0,1
Samurai Valerio,cosa fa,1,12570400000,12581600000,11200000,305,0,1
Samurai Valerio,non è neanche curioso di sentire cosa ho da dirle,1,12582400000,12608000000,25600000,306,0,1
Amedeo Cinaglia,no,1,12613200000,12623200000,10000000,307,0,1
Amedeo Cinaglia,io da lei non voglio sentire niente arrivederci,1,12625200000,12648400000,23200000,308,0,1
Samurai Valerio,un politico che prende l autobus,1,13305200000,13327600000,22400000,309,0,1
Samurai Valerio,di solito ci salite in campagna elettorale a caccia di voti,1,13356000000,13386800000,30800000,310,0,1
Amedeo Cinaglia,io lo prendo tutti i giorni,1,13403600000,13417600000,14000000,311,0,1
Samurai Valerio,perché lei è un vero rappresentante del popolo,1,13448800000,13472400000,23600000,312,0,1
Amedeo Cinaglia,esatto solo che non rappresento quelli come lei,1,13473200000,13504800000,31600000,313,0,1
Samurai Valerio,dice,1,13505600000,13515600000,10000000,314,0,1
Samurai Valerio,pensi che io posso anche averla votata,1,13524000000,13551600000,27600000,315,0,1
Amedeo Cinaglia,lo escludo,1,13524000000,13551600000,27600000,316,0,1
Samurai Valerio,roma ha bisogno di politici come lei,1,13570400000,13592000000,21600000,317,0,1
Samurai Valerio,politici che stanno in mezzo alla gente e amano questa città,1,13603200000,13635600000,32400000,318,0,1
Samurai Valerio,vanno valorizzati questi uomini perché ce ne sono sempre di meno,1,13726400000,13762000000,35600000,319,0,1
Amedeo Cinaglia,certo e lei sa come valorizzarli,1,13770000000,13796000000,26000000,320,0,1
Amedeo Cinaglia,ma in cambio,1,13810000000,13821200000,11200000,321,0,1
Amedeo Cinaglia,cosa vuole,1,13832000000,13840400000,8400000,322,0,1
Samurai Valerio,io e lei vogliamo la stessa cosa,1,13856400000,13874800000,18400000,323,0,1
Samurai Valerio,il bene di roma,1,13893200000,13906400000,13200000,324,0,1
Sara Monaschi,ehi come stai,1,14305600000,14325200000,19600000,325,0,0
Gabriele Marchilli,ciao,1,14305600000,14325200000,19600000,326,0,1
Gabriele Marchilli,mi sei mancata,1,14362400000,14376800000,14400000,327,0,1
Sara Monaschi,senti lele io ti ho chiamato perché mi serve il tuo aiuto,1,14406000000,14438800000,32800000,328,0,0
Sara Monaschi,devo organizzare una festa stasera mi devi dare una mano,1,14446400000,14476400000,30000000,329,0,0
Gabriele Marchilli,mi hai chiamato per una festa,1,14493600000,14522800000,29200000,330,0,1
Sara Monaschi,sì ma è una cosa importante,1,14493600000,14522800000,29200000,331,0,0
Sara Monaschi,un ospite particolare a cui tengo molto,1,14536800000,14568000000,31200000,332,0,0
Gabriele Marchilli,ci provo,1,14536800000,14568000000,31200000,333,0,1
Sara Monaschi,non mi basta un tentativo,1,14568800000,14586000000,17200000,334,0,0
Gabriele Marchilli,sara,1,14568800000,14586000000,17200000,335,0,1
Gabriele Marchilli,non mi chiami da tre mesi,1,14586800000,14610400000,23600000,336,0,1
Sara Monaschi,dai gabriele,1,14586800000,14610400000,23600000,337,0,0
Sara Monaschi,gabriele per favore,1,14611200000,14627200000,16000000,338,0,0
Gabriele Marchilli,va bene,1,14638000000,14653200000,15200000,339,0,1
Sara Monaschi,ti prego,1,14638000000,14653200000,15200000,340,0,0
Gabriele Marchilli,avrai le migliori puttane e la migliore cocaina di roma,1,14658800000,14681600000,22800000,341,1,1
Gabriele Marchilli,però è l ultima cosa che faccio per te,1,14682400000,14698000000,15600000,342,0,1
Livia Adami,guarda come s è ridotto sto posto fa schifo,1,14769600000,14801200000,31600000,343,0,0
Aureliano Adami,ma tu te lo devi immaginare diverso,1,14819600000,14857600000,38000000,344,0,1
Livia Adami,e quanto mi costa immaginarlo diverso,1,14819600000,14857600000,38000000,345,0,0
Aureliano Adami,una piotta o una piotta e mezzo,1,14858400000,14879600000,21200000,346,0,1
Aureliano Adami,tuo padre caccia i soldi per uno zingaro di merda ma niente per sistemare qui,1,14927200000,14971600000,44400000,347,1,1
Livia Adami,perché non gli proponi un altra cosa se non te lo vuole dare non te lo dà,1,14972400000,15008000000,35600000,348,0,0
Aureliano Adami,perché questo era di mamma,1,15008800000,15024400000,15600000,349,0,1
Aureliano Adami,io questo voglio non voglio un altra cosa,1,15052400000,15071200000,18800000,350,0,1
Livia Adami,ristorante discoteca e slot,1,15160400000,15183600000,23200000,351,0,0
Livia Adami,con meno di 300 000 euro non te la cavi aurelia,1,15184400000,15210000000,25600000,352,0,0
Aureliano Adami,i conti sono roba tua,1,15227200000,15245600000,18400000,353,0,1
Aureliano Adami,infatti questo posto devi gestirlo tu mica io,1,15275200000,15300000000,24800000,354,0,1
Livia Adami,facciamo una cosa tu chiedi scusa allo zingaro e io parlo con papà,1,15312400000,15350000000,37600000,355,0,0
Livia Adami,e vediamo che si può fare,1,15356000000,15370800000,14800000,356,0,0
Aureliano Adami,così avremo una cosa mia e tua senza quel rompicoglioni di mezzo,1,15396800000,15434000000,37200000,357,1,1
Aureliano Adami,il migliore stabilimento di ostia,1,15441200000,15462000000,20800000,358,0,1
Livia Adami,pareggia sta storia e io parlo con papà,1,15466400000,15492400000,26000000,359,0,0
Livia Adami,andiamo va che sento freddo,1,15511600000,15536800000,25200000,360,0,0
Aureliano Adami,facciamo che prima parli con papà,1,15590000000,15608000000,18000000,361,0,1
Aureliano Adami,se dice di sì pareggio la cosa con lo zingaro,1,15608800000,15636800000,28000000,362,0,1
Livia Adami,ti ho detto che c ho freddo andiamo,1,15663600000,15687200000,23600000,363,0,0
Livia Adami,facciamo una passerella che mi si rovinano le scarpe,1,15702400000,15741600000,39200000,364,0,0
Amedeo Cinaglia,ma che cazzo guardi mo vado lì e gli spacco la faccia,1,15969200000,16002800000,33600000,366,1,1
Amedeo Cinaglia,repetita iuvant,1,16042000000,16058400000,16400000,368,0,1
Amedeo Cinaglia,al mio umore,1,16059200000,16080400000,21200000,370,0,1
Amedeo Cinaglia,sapere se il sindaco ci ripenserà,1,16081200000,16102400000,21200000,372,0,1
Amedeo Cinaglia,il partito ha già scelto il prossimo candidato,1,16103200000,16126000000,22800000,374,0,1
Amedeo Cinaglia,non lo so gabriella,1,16148400000,16164000000,15600000,376,0,1
Amedeo Cinaglia,presto ci saranno nuove elezioni voglio che il partito mi sostenga,1,16164800000,16196000000,31200000,378,0,1
Amedeo Cinaglia,no,1,16196800000,16212800000,16000000,380,0,1
Amedeo Cinaglia,voi mi avete usato,1,16213600000,16224800000,11200000,381,0,1
Amedeo Cinaglia,vi sono serviti i voti delle periferie vi facevano comodo,1,16225600000,16253600000,28000000,382,0,1
Amedeo Cinaglia,poi invece mi avete sbattuto in una commissione del cazzo,1,16254400000,16279600000,25200000,383,1,1
Amedeo Cinaglia,non lo sono,1,16280400000,16300000000,19600000,385,0,1
Amedeo Cinaglia,voglio solo portare avanti le mie idee che un tempo erano anche le tue,1,16300800000,16331200000,30400000,386,0,1
Amedeo Cinaglia,dello stronzo lì in fondo non credo,1,16332000000,16362800000,30800000,387,1,1
Amedeo Cinaglia,voglio essere tra i primi tre della lista,1,16377600000,16395200000,17600000,389,0,1
Amedeo Cinaglia,e se vinciamo l assessorato alle politiche sociali,1,16396000000,16423200000,27200000,390,0,1
Amedeo Cinaglia,da quand è che lo fate scegliere,1,16466400000,16482400000,16000000,392,0,1
Amedeo Cinaglia,tu pensi che io non sono all altezza,1,16520000000,16538000000,18000000,394,0,1
Amedeo Cinaglia,perché,1,16550000000,16563200000,13200000,396,0,1
Amedeo Cinaglia,un povero coglione con degli ideali eh,1,16630400000,16652800000,22400000,399,1,1
Amedeo Cinaglia,sono un coglione,1,16659600000,16671200000,11600000,400,1,1
Amedeo Cinaglia,sono un coglione gabrie,1,16682400000,16695600000,13200000,401,1,1
Samurai Valerio,devi convincere theodosiou a far vendere quei terreni a noi,1,16865600000,16896400000,30800000,404,0,1
Samurai Valerio,dietro sto affare ci sono le famiglie di giù,1,16897200000,16915200000,18000000,405,0,1
Samurai Valerio,con la mafia non si scherza lo capisci o no,1,16916000000,16939600000,23600000,406,0,1
Samurai Valerio,eminenza hai riciclato i loro soldi per 30 anni,1,16980000000,17015600000,35600000,408,0,1
Samurai Valerio,la monaschi,1,17070000000,17084000000,14000000,409,0,1
Gabriele Marchilli,scusa,1,17270400000,17282800000,12400000,410,0,1
Gabriele Marchilli,scusa tu sei aureliano,1,17296400000,17315200000,18800000,411,0,1
Aureliano Adami,chi cazzo sei,1,17325200000,17351200000,26000000,412,1,1
Gabriele Marchilli,sergio ti ha chiamato,1,17325200000,17351200000,26000000,413,0,1
Aureliano Adami,ti ho chiesto chi cazzo sei,1,17356400000,17379200000,22800000,414,1,1
Gabriele Marchilli,sergio t ha chiamato o no,1,17385600000,17403600000,18000000,415,0,1
Aureliano Adami,che vuoi,1,17422800000,17431600000,8800000,416,0,1
Gabriele Marchilli,mi serve la coca,1,17438800000,17451600000,12800000,417,0,1
Aureliano Adami,ti pare che sto lavorando,1,17476000000,17492000000,16000000,418,0,1
Gabriele Marchilli,no però immagino che,1,17496400000,17516400000,20000000,419,0,1
Aureliano Adami,però un cazzo,1,17496400000,17516400000,20000000,420,1,1
Aureliano Adami,qua se vuoi parlare ti metti i guantoni,1,17543600000,17563200000,19600000,421,0,1
Gabriele Marchilli,stai scherzando,1,17571600000,17590400000,18800000,422,0,1
Aureliano Adami,no,1,17571600000,17590400000,18800000,423,0,1
Aureliano Adami,adria porta un paio di guantoni a sto ragazzo,1,17611600000,17643600000,32000000,424,0,1
Aureliano Adami,dai,1,17704400000,17712800000,8400000,425,0,1
Gabriele Marchilli,piano,1,17713600000,17735600000,22000000,426,0,1
Aureliano Adami,copriti,1,17713600000,17735600000,22000000,427,0,1
Aureliano Adami,copriti,1,17736400000,17761600000,25200000,428,0,1
Aureliano Adami,dai però va bene facciamo così,1,17770000000,17791600000,21600000,429,0,1
Aureliano Adami,facciamo così dai forza,1,17792400000,17812000000,19600000,430,0,1
Aureliano Adami,dai forza,1,17817600000,17845200000,27600000,431,0,1
Aureliano Adami,ma guarda mi ha preso,1,17909600000,17923200000,13600000,433,0,1
Aureliano Adami,mo possiamo parlare,1,18040800000,18054800000,14000000,434,0,1
Sara Monaschi,chi,1,18254000000,18262400000,8400000,437,0,0
Samurai Valerio,mi dispiace di averla interrotta,1,18396000000,18414000000,18000000,439,0,1
Samurai Valerio,ma passavo di qui ed ero curioso di conoscerla,1,18418400000,18444000000,25600000,440,0,1
Sara Monaschi,conoscermi,1,18468000000,18478800000,10800000,441,0,0
Samurai Valerio,beh ho sentito molto parlare di lei,1,18486400000,18507200000,20800000,442,0,1
Samurai Valerio,del fatto che adesso sta in quella commissione del vaticano,1,18513600000,18542400000,28800000,443,0,1
Samurai Valerio,perché non si siede,1,18559600000,18571200000,11600000,444,0,1
Sara Monaschi,senta che cosa vuole da me,1,18598400000,18628800000,30400000,445,0,0
Samurai Valerio,i terreni di ostia,1,18598400000,18628800000,30400000,446,0,1
Samurai Valerio,quei 20 ettari che adesso col nuovo piano regolatore diventeranno edificabili,1,18641600000,18679200000,37600000,447,0,1
Samurai Valerio,e che il vaticano deve solo decidere a chi vendere,1,18680000000,18706800000,26800000,448,0,1
Sara Monaschi,guardi che non sono io a decidere a chi vendere,1,18733600000,18755600000,22000000,449,0,0
Sara Monaschi,io sono solo un revisore dei conti,1,18756400000,18775200000,18800000,450,0,0
Sara Monaschi,mi dispiace ma non posso aiutarla,1,18780000000,18809600000,29600000,451,0,0
Samurai Valerio,dr ssa monaschi,1,18780000000,18809600000,29600000,452,0,1
Samurai Valerio,scommetto che mentre lei rivede i conti del vaticano,1,18863200000,18891600000,28400000,453,0,1
Samurai Valerio,quei terreni finiscono nelle mani della società di suo marito,1,18897200000,18932000000,34800000,454,0,1
Samurai Valerio,roma è una città chiacchierona le voci girano,1,18949600000,18982000000,32400000,455,0,1
Samurai Valerio,vede sapevo dove trovarla,1,18993200000,19011600000,18400000,456,0,1
Samurai Valerio,e so anche dove ritrovarla,1,19018800000,19037600000,18800000,457,0,1
Samurai Valerio,se serve,1,19042800000,19051600000,8800000,458,0,1
Samurai Valerio,ci pensi su,1,19082800000,19093600000,10800000,459,0,1
Samurai Valerio,mi faccia sapere quanto vuole per quei terreni,1,19102000000,19126000000,24000000,460,0,1
Samurai Valerio,posso essere molto generoso,1,19131600000,19151200000,19600000,461,0,1
Livia Adami,pa l idea di aureliano di ristrutturare il chiosco di mamma non è male,1,19360400000,19396400000,36000000,464,0,0
Livia Adami,guarda che l idea è buona ci si possono fare un sacco di soldi,1,19435200000,19468000000,32800000,466,0,0
Livia Adami,perché,1,19479200000,19497600000,18400000,468,0,0
Livia Adami,samurai,1,19643200000,19673200000,30000000,472,0,0
Livia Adami,che se ne fa samurai,1,19678000000,19693600000,15600000,473,0,0
Livia Adami,e noi che ci guadagniamo,1,19780400000,19794400000,14000000,476,0,0
Livia Adami,perché non l hai detto ad aureliano,1,19948400000,19966400000,18000000,481,0,0
Livia Adami,a me però le dici,1,20027200000,20045600000,18400000,483,0,0
Alberto Anacleti,perché chi lo dice,1,20365200000,20388000000,22800000,490,0,1
Alberto Anacleti,e che sono,1,20499600000,20510400000,10800000,494,0,1
Livia Adami,poca roba,1,20767600000,20782800000,15200000,499,0,0
Aureliano Adami,ha detto di no vero,1,20851200000,20866000000,14800000,500,0,1
Aureliano Adami,perché,1,20904000000,20913600000,9600000,501,0,1
Livia Adami,dice che non è un buon affare,1,20934400000,20950400000,16000000,502,0,0
Aureliano Adami,certo è un idea mia,1,20992000000,21008800000,16800000,503,0,1
Livia Adami,no non è per questo,1,21024400000,21037200000,12800000,504,0,0
Aureliano Adami,e perché allora,1,21042800000,21057200000,14400000,505,0,1
Livia Adami,la storia con gli zingari si deve risolvere,1,21068000000,21089200000,21200000,506,0,0
Livia Adami,è importante,1,21134000000,21146800000,12800000,507,0,0
Aureliano Adami,però a me non me ne frega un cazzo,1,21184000000,21199200000,15200000,508,1,1
Livia Adami,non lo vuoi fare perché te l ha chiesto papà,1,21218000000,21240000000,22000000,509,0,0
Livia Adami,fallo per me,1,21244800000,21254800000,10000000,510,0,0
Livia Adami,fallo perché te lo chiedo io,1,21277200000,21296000000,18800000,511,0,0
Livia Adami,aurelia,1,21309600000,21318800000,9200000,512,0,0
Livia Adami,oh,1,21356800000,21365600000,8800000,513,0,0
Livia Adami,mi rispondi,1,21395600000,21406800000,11200000,514,0,0
Gabriele Marchilli,sì,1,21862400000,21885200000,22800000,519,0,1
Gabriele Marchilli,manca la tesi,1,21891600000,21911600000,20000000,520,0,1
Gabriele Marchilli,boh mo vediamo,1,21912400000,21928800000,16400000,522,0,1
Gabriele Marchilli,scusate devo andare ciao gianni grazie,1,22043200000,22067600000,24400000,532,0,1
Gabriele Marchilli,grazie,1,22068400000,22086000000,17600000,534,0,1
Manfredi Anacleti,sta arrivando spadino,1,22361200000,22377600000,16400000,540,0,1
Alberto Anacleti,oh,1,22536400000,22545600000,9200000,543,0,1
Alberto Anacleti,dammene un altro,1,22551600000,22562400000,10800000,544,0,1
Alberto Anacleti,ti ho detto dammene un altro,1,22607200000,22627200000,20000000,546,0,1
Alberto Anacleti,dai canta,1,24188400000,24212800000,24400000,551,0,1
Alberto Anacleti,dai,1,24188400000,24212800000,24400000,552,0,1
Alberto Anacleti,canta,1,24213600000,24225200000,11600000,553,0,1
Alberto Anacleti,eh,1,24368000000,24390000000,22000000,556,0,1
Contessa Sveva Della Rocca Croce,mi raccomando col parcheggio non facciamo il solito casino,1,25388000000,25414000000,26000000,580,0,0
Contessa Sveva Della Rocca Croce,sono contenta che siate venuti nonostante il poco preavviso,1,25431200000,25464400000,33200000,582,0,0
Contessa Sveva Della Rocca Croce,ma chi poteva immaginare le dimissioni del sindaco proprio oggi,1,25465200000,25496800000,31600000,583,0,0
Contessa Sveva Della Rocca Croce,sandro carissimo,1,25497600000,25537600000,40000000,585,0,0
Contessa Sveva Della Rocca Croce,tu devi essere sara,1,25542800000,25566800000,24000000,586,0,0
Sara Monaschi,buonasera,1,25542800000,25566800000,24000000,587,0,0
Contessa Sveva Della Rocca Croce,tutta roma parla di te,1,25567600000,25584800000,17200000,588,0,0
Contessa Sveva Della Rocca Croce,una donna in vaticano fa sempre notizia,1,25592400000,25614400000,22000000,589,0,0
Contessa Sveva Della Rocca Croce,te la rubo un attimo permetti,1,25626800000,25653200000,26400000,590,0,0
Contessa Sveva Della Rocca Croce,sandro è un bravo ragazzo un po troppo formale,1,25683600000,25716400000,32800000,592,0,0
Contessa Sveva Della Rocca Croce,ma tra i gesuiti e la madre,1,25717200000,25737600000,20400000,593,0,0
Contessa Sveva Della Rocca Croce,guardali i ricchi di roma tutti costruttori palazzinari,1,25746800000,25789200000,42400000,594,0,0
Sara Monaschi,buonasera,1,25797600000,25816000000,18400000,595,0,0
Contessa Sveva Della Rocca Croce,buonasera avvocato,1,25820400000,25843600000,23200000,597,0,0
Contessa Sveva Della Rocca Croce,il sindaco si è dimesso e loro sono lì a disquisire sul futuro della città,1,25848800000,25894800000,46000000,599,0,0
Contessa Sveva Della Rocca Croce,un branco di lupi attorno a un osso,1,25900400000,25922400000,22000000,600,0,0
Contessa Sveva Della Rocca Croce,non dev essere facile per una donna stare in una commissione del genere,1,25946000000,25985600000,39600000,601,0,0
Contessa Sveva Della Rocca Croce,dove si decide sulle vendite e sui soldi del vaticano,1,25992000000,26022400000,30400000,602,0,0
Sara Monaschi,io sono solo un revisore dei conti non ho un ruolo decisionale,1,26023200000,26053600000,30400000,603,0,0
Contessa Sveva Della Rocca Croce,a una persona intelligente come te basta ascoltare,1,26054400000,26082800000,28400000,604,0,0
Contessa Sveva Della Rocca Croce,lo sa bene tuo marito che senza di te non saprebbe come muoversi,1,26087200000,26131200000,44000000,605,0,0
Contessa Sveva Della Rocca Croce,lo sanno benissimo anche gli investitori che stanno dietro la vostra società,1,26132000000,26170400000,38400000,606,0,0
Contessa Sveva Della Rocca Croce,soprattutto in questa situazione,1,26171200000,26192800000,21600000,607,0,0
Sara Monaschi,quale situazione,1,26198400000,26210000000,11600000,608,0,0
Contessa Sveva Della Rocca Croce,i terreni di ostia,1,26210800000,26228000000,17200000,609,0,0
Contessa Sveva Della Rocca Croce,prima li volevano tutti,1,26234800000,26253600000,18800000,610,0,0
Contessa Sveva Della Rocca Croce,adesso c è una persona che li pretende una persona che fa paura a tutta roma,1,26254400000,26294400000,40000000,611,0,0
Contessa Sveva Della Rocca Croce,per quello che può fare e soprattutto per quello che può dire,1,26300000000,26334800000,34800000,612,0,0
Sara Monaschi,credo di averla incontrata oggi,1,26348800000,26390000000,41200000,613,0,0
Contessa Sveva Della Rocca Croce,lo immaginavo,1,26348800000,26390000000,41200000,614,0,0
Contessa Sveva Della Rocca Croce,stai trattando con la persona che a roma ha sempre deciso tutto,1,26406000000,26444800000,38800000,615,0,0
Contessa Sveva Della Rocca Croce,sta a te scegliere se passare la mano,1,26469600000,26495200000,25600000,616,0,0
Contessa Sveva Della Rocca Croce,oppure rischiare,1,26501600000,26517200000,15600000,617,0,0
Samurai Valerio,e tuo padre,1,26789200000,26798000000,8800000,619,0,1
Samurai Valerio,niente devo solo accelerare i tempi,1,26873200000,26898800000,25600000,622,0,1
Samurai Valerio,è solo questione di tempo,1,26932800000,26950400000,17600000,624,0,1
Samurai Valerio,questo affare l ho creato io,1,27001600000,27018400000,16800000,626,0,1
Samurai Valerio,e so come gestire roma e i suoi tempi,1,27024000000,27047200000,23200000,627,0,1
Samurai Valerio,tuo padre conosce gli uomini,1,27243200000,27260800000,17600000,633,0,1
Amedeo Cinaglia,sì,1,27724800000,27734800000,10000000,637,0,1
Amedeo Cinaglia,come mai,1,27780000000,27789200000,9200000,640,0,1
Amedeo Cinaglia,che c entra la preside,1,27935600000,27946400000,10800000,646,0,1
Amedeo Cinaglia,infatti io lo so certo sì,1,28061600000,28088400000,26800000,650,0,1
Amedeo Cinaglia,certo,1,28252800000,28262800000,10000000,653,0,1
Amedeo Cinaglia,ora vengo,1,28401600000,28416400000,14800000,656,0,1
Aureliano Adami,quel coglione non viene,1,29456000000,29472800000,16800000,660,1,1
Aureliano Adami,tie,1,29894400000,29903200000,8800000,664,0,1
Aureliano Adami,ti ho fatto un favore,1,30030000000,30047600000,17600000,665,0,1
Aureliano Adami,con questo coso sul naso non senti sta puzza di merda che ti porti dietro,1,30076400000,30117200000,40800000,666,1,1
Gabriele Marchilli,cazzo,1,30398400000,30408400000,10000000,672,1,1
Gabriele Marchilli,buonasera,1,30464000000,30480400000,16400000,673,0,1
Gabriele Marchilli,c è una stanza giù per cambiarvi,1,30481200000,30498000000,16800000,675,0,1
Gabriele Marchilli,sergio quello stronzo dell amico tuo non si è presentato e non mi risponde,1,30626800000,30664000000,37200000,677,1,1
Gabriele Marchilli,non posso aspettare perché la gente sta arrivando,1,30672800000,30698400000,25600000,678,0,1
Gabriele Marchilli,trovami una soluzione,1,30711200000,30725200000,14000000,679,0,1
Aureliano Adami,vieni qua pezzo di merda,1,31237200000,31248800000,11600000,692,1,1
Aureliano Adami,dai,1,32146400000,32155200000,8800000,700,0,1
Aureliano Adami,cazzo,1,32337200000,32348800000,11600000,702,1,1
Manfredi Anacleti,bisogna che impari a stare al mondo,1,32647200000,32667600000,20400000,703,0,1
Manfredi Anacleti,ti sei messo a fare il piripicchio,1,32668400000,32688000000,19600000,704,0,1
Manfredi Anacleti,buffone,1,32688800000,32701600000,12800000,705,0,1
Alberto Anacleti,non ho un cazzo da imparare da te,1,32710000000,32730800000,20800000,706,1,1
Manfredi Anacleti,mi hai fatto fare una figura di merda,1,32731600000,32752400000,20800000,707,1,1
Manfredi Anacleti,ti sei presentato ubriaco la sera della festa,1,32753200000,32780400000,27200000,708,0,1
Manfredi Anacleti,hai capito che vuol dire sto matrimonio per la famiglia nostra,1,32781200000,32811200000,30000000,709,0,1
Alberto Anacleti,per noi per te,1,32812000000,32823600000,11600000,710,0,1
Manfredi Anacleti,intanto c è da andare a una villa a ritirare i soldi di una consegna,1,32841600000,32876000000,34400000,711,0,1
Manfredi Anacleti,devi muovere il culo hai capito o no,1,32876800000,32894000000,17200000,712,1,1
Manfredi Anacleti,almeno capisci che non puoi fare sempre come cazzo ti pare,1,32894800000,32920000000,25200000,713,1,1
Alberto Anacleti,meno male avevo voglia di lavorare dopo sta rottura di coglioni,1,32920800000,32948800000,28000000,714,1,1
Aureliano Adami,stai zitto,1,33068000000,33077600000,9600000,716,0,1
Aureliano Adami,ho detto di stare zitto o ti butto sotto la macchina,1,33106400000,33145600000,39200000,717,0,1
Gabriele Marchilli,guarda che ci stanno tutti,1,33386800000,33402800000,16000000,719,0,1
Alberto Anacleti,sì ma io li conto sai com è,1,33403600000,33422400000,18800000,720,0,1
Aureliano Adami,che ci fa qua sta merda,1,33516000000,33535200000,19200000,721,1,1
Gabriele Marchilli,ti ho chiamato tre volte anzi mi stavi per far fare,1,33540000000,33564000000,24000000,722,0,1
Aureliano Adami,che stavo per farti fare pezzo di merda,1,33564800000,33582800000,18000000,723,1,1
Aureliano Adami,mettiti qui e non ti muovere o ti sfondo hai capito,1,33583600000,33610000000,26400000,724,0,1
Aureliano Adami,avete rotto il cazzo te ne devi andare da qua zingaro di merda,1,33618400000,33644800000,26400000,725,1,1
Alberto Anacleti,oddio scusa non t hanno detto che io vado dove cazzo mi pare,1,33645600000,33676800000,31200000,726,1,1
Aureliano Adami,chi cazzo è questo,1,33722000000,33738000000,16000000,729,1,1
Gabriele Marchilli,oh,1,33738800000,33748400000,9600000,730,0,1
Alberto Anacleti,quanto cazzo ha pippato,1,33749200000,33766000000,16800000,731,1,1
Aureliano Adami,è la roba di merda che vendete voi,1,33766800000,33791600000,24800000,732,1,1
Gabriele Marchilli,respira,1,33766800000,33791600000,24800000,733,0,1
Gabriele Marchilli,mi date una mano a tirarlo su,1,33792400000,33826000000,33600000,734,0,1
Alberto Anacleti,no lo devi lasciare giù,1,33792400000,33826000000,33600000,735,0,1
Alberto Anacleti,stai buono,1,33826800000,33841600000,14800000,736,0,1
Gabriele Marchilli,come cazzo faccio mo,1,33842400000,33856000000,13600000,737,1,1
Aureliano Adami,ti conviene chiamare un ambulanza questo mo stira,1,33876800000,33904000000,27200000,738,0,1
Gabriele Marchilli,cazzo,1,33904800000,33928800000,24000000,739,1,1
Alberto Anacleti,aspetta che gli passa mo gli passa,1,33904800000,33928800000,24000000,740,0,1
Aureliano Adami,perché non chiami l ambulanza chi cazzo è questo,1,33935600000,33960000000,24400000,741,1,1
Gabriele Marchilli,è un prete cazzo non la posso chiamare l ambulanza,1,33965200000,33996000000,30800000,742,1,1
Alberto Anacleti,questo è un prete,1,33996800000,34009600000,12800000,743,0,1
Alberto Anacleti,eh,1,34015200000,34024000000,8800000,744,0,1
Alberto Anacleti,amico mio questo è un prete,1,34030000000,34048800000,18800000,745,0,1
Alberto Anacleti,quanto è grosso sto prete più è grosso più soldi sono,1,34049600000,34077200000,27600000,746,0,1
Gabriele Marchilli,che soldi,1,34078000000,34095200000,17200000,747,0,1
Alberto Anacleti,pippa tromba e sturba,1,34078000000,34095200000,17200000,748,1,1
Alberto Anacleti,più è grosso e più paga per non farlo sapere in giro,1,34096000000,34118400000,22400000,749,0,1
Gabriele Marchilli,sono gabriele,1,34119200000,34139200000,20000000,750,0,1
Alberto Anacleti,mo chi cazzo sta a chiamare,1,34119200000,34139200000,20000000,751,1,1
Aureliano Adami,che cazzo ne so,1,34140000000,34152000000,12000000,752,1,1
Gabriele Marchilli,senti è successo un casino il prete ha collassato,1,34157600000,34189200000,31600000,753,0,1
Gabriele Marchilli,io non ho fatto niente,1,34217200000,34229600000,12400000,754,0,1
Aureliano Adami,stavi spiando,1,34243600000,34272800000,29200000,755,0,1
Aureliano Adami,che hai là,1,34273600000,34282800000,9200000,757,0,1
Gabriele Marchilli,è colpa mia se quello ha collassato,1,34351600000,34372400000,20800000,760,0,1
Aureliano Adami,facevi un filmino,1,34391200000,34401600000,10400000,761,0,1
Aureliano Adami,gli volevi chiedere la stecca zoccola,1,34444000000,34464400000,20400000,763,1,1
Aureliano Adami,non ti muovere,1,34511600000,34520400000,8800000,764,0,1
Alberto Anacleti,stasera ti togliamo tutto,1,34542400000,34559200000,16800000,766,0,1
Aureliano Adami,si stava divertendo il prete,1,34569200000,34619200000,50000000,767,0,1
Alberto Anacleti,vedi che robetta ti dai da fare,1,34569200000,34619200000,50000000,768,0,1
Gabriele Marchilli,stanno venendo a prenderlo,1,34620000000,34650800000,30800000,769,0,1
Aureliano Adami,così mi fai sapere dove lo portano,1,34620000000,34650800000,30800000,770,0,1
Alberto Anacleti,ragazzi c è un problema,1,34656400000,34674400000,18000000,771,0,1
Alberto Anacleti,l idea è mia il prete me lo prendo io,1,34685200000,34725200000,40000000,772,0,1
Aureliano Adami,il telefono ce l ho io come facciamo,1,34685200000,34725200000,40000000,773,0,1
Alberto Anacleti,il prete me lo prendo io,1,34745600000,34756800000,11200000,774,0,1
Gabriele Marchilli,siete matti,1,34762400000,34776000000,13600000,775,0,1
Aureliano Adami,zitto,1,34762400000,34776000000,13600000,776,0,1
Gabriele Marchilli,volete ricattare il prete,1,34776800000,34792800000,16000000,777,0,1
Aureliano Adami,zitto,1,34776800000,34792800000,16000000,778,0,1
Aureliano Adami,non sbagliare con me io ti faccio male,1,34807600000,34825600000,18000000,779,0,1
Alberto Anacleti,te lo rispiego il prete è roba mia,1,34826400000,34852400000,26000000,780,0,1
Alberto Anacleti,se vuoi ti do una percentuale il 5,1,34853200000,34871200000,18000000,781,0,1
Aureliano Adami,il 5 dallo a quel parassita di tuo fratello,1,34872000000,34894400000,22400000,782,0,1
Aureliano Adami,che la famiglia tua non è buona neanche per pulirci il culo,1,34895200000,34918800000,23600000,783,1,1
Aureliano Adami,a chi a voi i cravattari di ostia,1,34919600000,34934400000,14800000,784,0,1
Alberto Anacleti,ma vattene affanculo,1,34935200000,34961600000,26400000,785,1,1
Aureliano Adami,vieni qua pezzo di merda,1,34935200000,34961600000,26400000,786,1,1
Gabriele Marchilli,voglio un terzo dei soldi,1,34996000000,35012400000,16400000,787,0,1
Aureliano Adami,con te finisco dopo tu che hai detto,1,35061200000,35105200000,44000000,788,0,1
Gabriele Marchilli,ricattiamo il prete ma voglio un terzo,1,35061200000,35105200000,44000000,789,0,1
Gabriele Marchilli,io vi posso far sapere chi è quanto è grosso,1,35106000000,35137200000,31200000,790,0,1
Gabriele Marchilli,però dividiamo in tre,1,35138000000,35151200000,13200000,791,0,1
Gabriele Marchilli,allora,1,35174400000,35187200000,12800000,792,0,1
Aureliano Adami,allora un cazzo mo s è messo a parlare pure questo,1,35188000000,35220000000,32000000,793,1,1
Gabriele Marchilli,lo stanno venendo a prendere è meglio che ti sbrighi a decidere,1,35220800000,35249200000,28400000,794,0,1
Alberto Anacleti,ma è grosso davvero,1,35259200000,35271200000,12000000,795,0,1
Alberto Anacleti,da dividerlo in tre,1,35276000000,35288400000,12400000,796,0,1
Gabriele Marchilli,è grosso,1,35289200000,35314000000,24800000,797,0,1
Aureliano Adami,non me ne frega un cazzo,1,35289200000,35314000000,24800000,798,1,1
Alberto Anacleti,perché,1,35314800000,35337600000,22800000,799,0,1
Aureliano Adami,non faccio impicci con voi due,1,35314800000,35337600000,22800000,800,0,1
Alberto Anacleti,pensaci un attimo ci spartiamo una fetta per uno,1,35338400000,35363600000,25200000,801,0,1
Alberto Anacleti,poi da domani ognuno per i cazzi suoi,1,35370000000,35389200000,19200000,802,1,1
Alberto Anacleti,allora,1,35464400000,35476400000,12000000,803,0,1
Alberto Anacleti,ci stai,1,35506000000,35517600000,11600000,804,0,1
Aureliano Adami,zitto non ti muovere che ti sparo in faccia,2,803600000,826400000,22800000,9,0,1
Aureliano Adami,dai di corsa,2,1291999999,1305200000,13200001,10,0,1
Samurai Valerio,la suburra,2,1621600000,1633600000,12000000,11,0,1
Samurai Valerio,sto posto non cambia da 2000 anni,2,1650800000,1671200000,20400000,12,0,1
Samurai Valerio,patrizi e plebei politici e criminali,2,1682800000,1717200000,34400000,13,0,1
Samurai Valerio,mignotte e preti,2,1718000000,1732800000,14800000,14,1,1
Samurai Valerio,roma,2,1743200000,1754800000,11600000,15,0,1
Amedeo Cinaglia,ora però ci abitano i ricchi,2,1823200000,1854000000,30800000,16,0,1
Samurai Valerio,ha fatto bene a chiamarmi,2,1823200000,1854000000,30800000,17,0,1
Samurai Valerio,perché voglio aiutarla a trovare il suo spazio in questo mondo,2,1854800000,1886000000,31200000,18,0,1
Amedeo Cinaglia,senta cosa vuole da me,2,1897600000,1911200000,13600000,19,0,1
Samurai Valerio,la pratica per unificare i terreni di ostia,2,1924000000,1946400000,22400000,20,0,1
Samurai Valerio,voglio che venga approvata prima che le dimissioni del sindaco siano effettive,2,1956000000,1994800000,38800000,21,0,1
Amedeo Cinaglia,i terreni di ostia hanno proprietari diversi,2,2015200000,2035200000,20000000,22,0,1
Amedeo Cinaglia,la chiesa ha il pezzo più grosso ma chi le dice che voglia unirli,2,2036000000,2062800000,26800000,23,0,1
Amedeo Cinaglia,comunque per l approvazione definitiva serve la firma del dirigente,2,2070800000,2106400000,35600000,24,0,1
Samurai Valerio,finucci non è un problema,2,2107200000,2123600000,16400000,25,0,1
Samurai Valerio,preti criminali e dirigenti comunali,2,2129200000,2154000000,24800000,26,0,1
Samurai Valerio,le carte sono già truccate sa chi manca,2,2159600000,2186400000,26800000,27,0,1
Samurai Valerio,lei,2,2190800000,2199200000,8400000,28,0,1
Samurai Valerio,cosa vuole,2,2248400000,2258800000,10400000,29,0,1
Samurai Valerio,è venuto qui senza sapere cosa chiedere,2,2302800000,2324800000,22000000,30,0,1
Samurai Valerio,allora proprio non mi sbagliavo,2,2325600000,2353200000,27600000,31,0,1
Amedeo Cinaglia,che cazzo vuol dire,2,2325600000,2353200000,27600000,32,1,1
Samurai Valerio,lei è come un bambino che vuole essere apprezzato,2,2354000000,2380000000,26000000,33,0,1
Samurai Valerio,ma scopre che il mondo dei grandi ha altre regole altri interessi,2,2380800000,2410800000,30000000,34,0,1
Samurai Valerio,per questo è qua per capire come funziona,2,2411600000,2435200000,23600000,35,0,1
Samurai Valerio,non è così,2,2462800000,2471200000,8400000,36,0,1
Alberto Anacleti,statti zitto,2,2652400000,2667600000,15200000,37,0,1
Alberto Anacleti,mo ti faccio vedere un bel filmetto tie,2,2673200000,2701200000,28000000,38,0,1
Alberto Anacleti,eh,2,2709200000,2717600000,8400000,39,0,1
Alberto Anacleti,ti dai da fare eh,2,2736800000,2754000000,17200000,41,0,1
Alberto Anacleti,oh pensa che succede se sta cosa va in giro,2,2754800000,2791600000,36800000,42,0,1
Alberto Anacleti,pensa che succede,2,2803200000,2816400000,13200000,43,0,1
Alberto Anacleti,infatti fai bene a dire di no,2,2821200000,2845600000,24400000,44,0,1
Alberto Anacleti,comunque basta che mi dai un sacco di soldi,2,2852800000,2883600000,30800000,45,0,1
Alberto Anacleti,e io ti prometto che questa cosa non la vede nessuno,2,2890400000,2922800000,32400000,46,0,1
Alberto Anacleti,mo puoi parlare,2,2936000000,2946800000,10800000,47,0,1
Alberto Anacleti,ma con 300 000 stai tranquillo,2,2991600000,3014800000,23200000,49,0,1
Alberto Anacleti,non serve che dici altro,2,3028000000,3042400000,14400000,51,0,1
Alberto Anacleti,me li devi dare oggi alle 16 00,2,3050400000,3071200000,20800000,52,0,1
Livia Adami,no,2,3235200000,3252800000,17600000,56,0,0
Livia Adami,scusa dicevi nella zona nord,2,3263200000,3290800000,27600000,57,0,0
Aureliano Adami,abbiamo chi,2,3342000000,3355200000,13200000,59,0,1
Aureliano Adami,è roba di famiglia quirino tu devi fare i conti e basta,2,3425200000,3451200000,26000000,61,0,1
Aureliano Adami,rifalli,2,3483200000,3493200000,10000000,63,0,1
Aureliano Adami,magari ti sbagli,2,3502000000,3515600000,13600000,64,0,1
Livia Adami,aurelia aspetta dobbiamo parlare,2,3585600000,3612000000,26400000,66,0,0
Aureliano Adami,c ho da fare,2,3585600000,3612000000,26400000,67,0,1
Aureliano Adami,parliamo un altra volta,2,3612800000,3630400000,17600000,68,0,1
Livia Adami,senti non dire niente a mio padre,2,3698800000,3747200000,48400000,69,0,0
Livia Adami,non gli dire niente me la vedo io,2,3752400000,3774400000,22000000,71,0,0
Livia Adami,anzi fammi vedere,2,3780000000,3791600000,11600000,72,0,0
Manfredi Anacleti,spadi,2,3929200000,3952400000,23200000,76,0,1
Manfredi Anacleti,spadi,2,3974000000,3983200000,9200000,79,0,1
Alberto Anacleti,che vuoi,2,3996000000,4011600000,15600000,80,0,1
Manfredi Anacleti,si può sapere dove sei stato,2,4012400000,4027600000,15200000,81,0,1
Manfredi Anacleti,ridi,2,4028400000,4038800000,10400000,82,0,1
Manfredi Anacleti,che cazzo ridi,2,4039600000,4052400000,12800000,83,1,1
Manfredi Anacleti,tuo cugino è sparito ieri sera l ultima volta l hanno visto con adami,2,4053200000,4092000000,38800000,84,0,1
Alberto Anacleti,si sarà sputtanato tutto a mignotte come fa di solito,2,4108800000,4138000000,29200000,85,1,1
Manfredi Anacleti,può essere ma noi lo dobbiamo trovare,2,4143600000,4162000000,18400000,86,0,1
Manfredi Anacleti,con questi di ostia non si scherza spadi questi sono merde,2,4162800000,4196400000,33600000,87,1,1
Manfredi Anacleti,preoccupati del ricevimento,2,4212000000,4228000000,16000000,89,0,1
Manfredi Anacleti,e non fare danni,2,4238800000,4252000000,13200000,91,0,1
Gabriele Marchilli,allora,2,4593200000,4601600000,8400000,100,0,1
Gabriele Marchilli,dici,2,4669200000,4691600000,22400000,103,0,1
Gabriele Marchilli,sì,2,4726000000,4738000000,12000000,106,0,1
Gabriele Marchilli,mi sembra un po caro però,2,4749200000,4779600000,30400000,107,0,1
Gabriele Marchilli,ok,2,4838400000,4846800000,8400000,111,0,1
Gabriele Marchilli,sì,2,4860400000,4880000000,19600000,114,0,1
Gabriele Marchilli,no sono i soliti rompipalle che cercano di vendere qualcosa,2,4912000000,4946800000,34800000,115,1,1
Gabriele Marchilli,va bene allora faccio fare l orlo,2,4962800000,4987200000,24400000,116,0,1
Gabriele Marchilli,sì,2,4988000000,5014800000,26800000,119,0,1
Gabriele Marchilli,pronto,2,5099600000,5110800000,11200000,121,0,1
Gabriele Marchilli,sì ho i soldi te li porto alle 18 00,2,5122000000,5147600000,25600000,122,0,1
Gabriele Marchilli,sì 20 000,2,5152000000,5168400000,16400000,123,0,1
Gabriele Marchilli,alle 18 00,2,5169199999,5182400000,13200001,124,0,1
Sara Monaschi,un video,2,5293600000,5320800000,27200000,126,0,0
Sara Monaschi,che cosa si vede in questo video,2,5359600000,5381200000,21600000,129,0,0
Sara Monaschi,non dica così monsignore non è così,2,5430000000,5454400000,24400000,133,0,0
Sara Monaschi,mi ascolti,2,5508400000,5520400000,12000000,136,0,0
Sara Monaschi,adesso dobbiamo risolvere questo disastro,2,5526000000,5551600000,25600000,137,0,0
Sara Monaschi,insieme,2,5552400000,5561600000,9200000,138,0,0
Sara Monaschi,vuole che l aiuti sì o no,2,5619600000,5638800000,19200000,141,0,0
Angelica Sale,la conchiglia,2,5972400000,5988000000,15600000,149,0,0
Alberto Anacleti,serve una prova per sta pagliacciata,2,6160400000,6179200000,18800000,156,0,1
Alberto Anacleti,va bene dove la devo portare,2,6200000000,6212800000,12800000,158,0,1
Alberto Anacleti,andiamo,2,6213600000,6229600000,16000000,160,0,1
Alberto Anacleti,ecco,2,6397600000,6406000000,8400000,166,0,1
Alberto Anacleti,scegliamo sti menu,2,6415200000,6430800000,15600000,167,0,1
Angelica Sale,proprio non ti va di fare sta cosa eh,2,6527600000,6547200000,19600000,168,0,0
Alberto Anacleti,scegliere da mangiare per gli altri non mi viene tanto bene,2,6557200000,6587600000,30400000,169,0,1
Angelica Sale,cos è che ti viene bene,2,6588400000,6602800000,14400000,170,0,0
Alberto Anacleti,tante cose,2,6620800000,6634800000,14000000,171,0,1
Alberto Anacleti,tranne stare qua,2,6651600000,6661600000,10000000,172,0,1
Angelica Sale,e facciamone una dai,2,6672400000,6685200000,12800000,173,0,0
Gabriele Marchilli,allora,2,6816800000,6837200000,20400000,174,0,1
Sara Monaschi,hai fatto un gran casino lo sai,2,6816800000,6837200000,20400000,175,0,0
Gabriele Marchilli,ti calmi,2,6838000000,6857600000,19600000,176,0,1
Sara Monaschi,calma un cazzo,2,6838000000,6857600000,19600000,177,1,0
Sara Monaschi,qualcuno alla festa ha fatto un video al prete e ora lo sta ricattando,2,6862400000,6899200000,36800000,178,0,0
Gabriele Marchilli,un video,2,6900000000,6910000000,10000000,179,0,1
Sara Monaschi,sì,2,6900000000,6910000000,10000000,180,0,0
Sara Monaschi,tu ne sai qualcosa,2,6910800000,6922400000,11600000,181,0,0
Gabriele Marchilli,ho fatto solo ciò che mi hai chiesto tu,2,6923200000,6950400000,27200000,182,0,1
Sara Monaschi,solo,2,6923200000,6950400000,27200000,183,0,0
Sara Monaschi,magari eri incazzato con me e hai trovato l occasione,2,6951200000,6981600000,30400000,184,1,0
Sara Monaschi,aspetta lele,2,6987200000,6997600000,10400000,185,0,0
Gabriele Marchilli,veramente pensi che ti potrei fare questo,2,7025200000,7046000000,20800000,186,0,1
Gabriele Marchilli,veramente,2,7062000000,7070400000,8400000,187,0,1
Sara Monaschi,ma la festa l hai organizzata tu,2,7075200000,7092800000,17600000,188,0,0
Sara Monaschi,le persone le hai scelte tu,2,7098000000,7114000000,16000000,189,0,0
Sara Monaschi,e adesso tu mi devi aiutare a risolvere questo casino,2,7114800000,7142000000,27200000,190,0,0
Sara Monaschi,il ricatto lo sta facendo un ragazzetto,2,7162400000,7185600000,23200000,191,0,0
Sara Monaschi,uno piccolo bruno coi capelli rasati l aria da bullo,2,7186400000,7215200000,28800000,192,0,0
Gabriele Marchilli,sara così ce ne stanno tanti però,2,7216000000,7232800000,16800000,193,0,1
Sara Monaschi,ma tu non sai neanche chi cazzo c era a sta festa scusa,2,7233600000,7259200000,25600000,194,1,0
Sara Monaschi,c è una prostituta nel video una nera,2,7260000000,7282000000,22000000,195,0,0
Sara Monaschi,quella te la ricordi almeno la conosci,2,7282800000,7306800000,24000000,196,0,0
Gabriele Marchilli,sì,2,7282800000,7306800000,24000000,197,0,1
Sara Monaschi,e chi è,2,7314000000,7322800000,8800000,198,0,0
Gabriele Marchilli,una delle tante,2,7327600000,7338000000,10400000,199,0,1
Sara Monaschi,voglio sapere chi è tu la devi trovare perché lei è sicuramente coinvolta,2,7353600000,7389600000,36000000,200,0,0
Gabriele Marchilli,tu comunque mi devi ancora pagare,2,7406800000,7433200000,26400000,201,0,1
Sara Monaschi,trova la ragazza,2,7406800000,7433200000,26400000,202,0,0
Sara Monaschi,trovala,2,7444800000,7455600000,10800000,203,0,0
Angelica Sale,ma sto posto è tuo,2,7550000000,7564000000,14000000,205,0,0
Alberto Anacleti,è della famiglia,2,7580400000,7592800000,12400000,206,0,1
Angelica Sale,quindi è pure tuo no,2,7593600000,7616800000,23200000,207,0,0
Alberto Anacleti,è della famiglia,2,7593600000,7616800000,23200000,208,0,1
Angelica Sale,che fai ci vieni a ballare,2,7659200000,7670000000,10800000,209,0,0
Alberto Anacleti,no,2,7693200000,7701600000,8400000,210,0,1
Alberto Anacleti,io ci vengo di giorno,2,7731600000,7747200000,15600000,211,0,1
Alberto Anacleti,quando non c è nessuno che mi rompe i coglioni,2,7754800000,7779600000,24800000,212,1,1
Angelica Sale,una volta ci veniamo a ballare insieme,2,7822000000,7842000000,20000000,214,0,0
Alberto Anacleti,le mogli stanno a casa,2,7847600000,7862800000,15200000,215,0,1
Angelica Sale,sì forse 20 anni fa,2,7863600000,7884000000,20400000,216,0,0
Alberto Anacleti,poi a te questa musica non piace,2,7889600000,7931600000,42000000,217,0,1
Angelica Sale,a me piace ballare come a te,2,7889600000,7931600000,42000000,218,0,0
Alberto Anacleti,devo andare aspettami qua,2,7989600000,8005200000,15600000,220,0,1
Aureliano Adami,che c è che cattiveria vieni qua,2,8150400000,8186000000,35600000,221,0,1
Aureliano Adami,sei cattivuccio eh,2,8186800000,8197200000,10400000,222,0,1
Aureliano Adami,pronto,2,8259600000,8270000000,10400000,224,0,1
Aureliano Adami,lo sapevo che quel pezzo di merda del prete chiacchierava,2,8300400000,8331200000,30800000,225,1,1
Aureliano Adami,ma chi è questa,2,8338800000,8348000000,9200000,226,0,1
Gabriele Marchilli,è quella che mi ha detto di organizzare la festa sta nella roma che conta,2,8353600000,8387600000,34000000,227,0,1
Aureliano Adami,sai che cazzo me ne frega a me,2,8388400000,8406800000,18400000,228,1,1
Gabriele Marchilli,e comunque vuole che rintraccio la nera,2,8407600000,8431200000,23600000,229,0,1
Alberto Anacleti,quella ci ha visto potrebbe essere un problema,2,8435600000,8458000000,22400000,230,0,1
Aureliano Adami,alla zoccola ci penso io ma al prete va fatto capire che non scherziamo,2,8458800000,8500400000,41600000,231,1,1
Aureliano Adami,spadi metti il video su internet un pezzetto senza far vedere la faccia,2,8506000000,8546800000,40800000,232,0,1
Aureliano Adami,solo per fargli paura,2,8547600000,8579200000,31600000,233,0,1
Alberto Anacleti,quando si è deciso che comandi te,2,8547600000,8579200000,31600000,234,0,1
Aureliano Adami,un anacleti non può comandare spadi,2,8593600000,8632000000,38400000,235,0,1
Alberto Anacleti,non me ne frega un cazzo di comandare,2,8593600000,8632000000,38400000,236,1,1
Alberto Anacleti,ma non mi va neanche di prendere ordini quindi stavolta facciamo senza capi,2,8632800000,8671600000,38800000,237,0,1
Aureliano Adami,avessimo trovato l unico zingaro che ragiona,2,8720000000,8748000000,28000000,238,0,1
Aureliano Adami,vieni con me voglio vedere se ragioni pure te,2,8812400000,8838000000,25600000,239,0,1
Aureliano Adami,non mi piace essere preso per il culo,2,8980800000,9002800000,22000000,240,1,1
Gabriele Marchilli,che significa,2,9020000000,9031200000,11200000,241,0,1
Aureliano Adami,sei amico di quella della roma che conta,2,9040000000,9061600000,21600000,242,0,1
Gabriele Marchilli,beh,2,9062400000,9091200000,28800000,243,0,1
Aureliano Adami,e sei pure figlio di una guardia,2,9062400000,9091200000,28800000,244,0,1
Gabriele Marchilli,che ne sai di mio padre,2,9110800000,9126800000,16000000,245,0,1
Aureliano Adami,pensi che lavoro con qualcuno senza sapere chi cazzo è,2,9127600000,9153600000,26000000,246,1,1
Gabriele Marchilli,un conto sono io e un conto è mio padre,2,9172400000,9193200000,20800000,247,0,1
Aureliano Adami,vedremo,2,9222400000,9232800000,10400000,248,0,1
Alberto Anacleti,sì,2,9410000000,9420800000,10800000,251,0,1
Alberto Anacleti,tanto sono femmine poi gli passa,2,9428800000,9446800000,18000000,252,0,1
Aureliano Adami,abita qua questa,2,9647200000,9660000000,12800000,253,0,1
Gabriele Marchilli,sì abita qua,2,9668000000,9678800000,10800000,254,0,1
Gabriele Marchilli,però non so l interno,2,9690800000,9702000000,11200000,255,0,1
Aureliano Adami,va bene andiamo,2,9707600000,9717600000,10000000,256,0,1
Aureliano Adami,qual è questo,2,9808400000,9829600000,21200000,257,0,1
Gabriele Marchilli,sì credo di sì,2,9808400000,9829600000,21200000,258,0,1
Aureliano Adami,mo quale cazzo è,2,9843600000,9860000000,16400000,259,1,1
Aureliano Adami,scusa sai dove abita,2,9902000000,9926000000,24000000,261,0,1
Gabriele Marchilli,isabel,2,9902000000,9926000000,24000000,262,0,1
Aureliano Adami,sì,2,9926800000,9944400000,17600000,264,0,1
Aureliano Adami,dimmi dove abita questa,2,9965200000,9987200000,22000000,266,0,1
Aureliano Adami,grazie,2,10015200000,10026400000,11200000,269,0,1
Aureliano Adami,chiudi quel portone,2,10077600000,10088000000,10400000,271,0,1
Gabriele Marchilli,che ci devi fare con quella,2,10131200000,10149200000,18000000,272,0,1
Aureliano Adami,io niente devi ammazzare la zoccola,2,10150000000,10171200000,21200000,273,1,1
Gabriele Marchilli,io non ammazzo nessuno,2,10188800000,10209200000,20400000,274,0,1
Aureliano Adami,ah no,2,10188800000,10209200000,20400000,275,0,1
Aureliano Adami,vuoi chiamare papà,2,10220800000,10231600000,10800000,276,0,1
Aureliano Adami,gli vuoi chiedere quanto fai per traffico di stupefacenti e ricatto,2,10237200000,10266400000,29200000,277,0,1
Gabriele Marchilli,cazzo ci dev essere un altro modo,2,10272000000,10305200000,33200000,278,1,1
Aureliano Adami,no ci ha visto in faccia,2,10272000000,10305200000,33200000,279,0,1
Aureliano Adami,è così che vuoi fare il criminale le,2,10363599999,10381600000,18000001,280,0,1
Aureliano Adami,rimani qua e fai il palo,2,10420799999,10439200000,18400001,281,0,1
Aureliano Adami,così se mi becco omicidio sei complice,2,10453599999,10474000000,20400001,282,0,1
Aureliano Adami,ti conviene stare qua quando torno o ti vengo a cercare,2,10494000000,10522400000,28400000,283,0,1
Aureliano Adami,e poi sono cazzi tuoi,2,10528400000,10541600000,13200000,284,1,1
Aureliano Adami,vieni qua,2,11446000000,11464400000,18400000,289,0,1
Aureliano Adami,vieni qua,2,11486000000,11510800000,24800000,291,0,1
Aureliano Adami,zitta,2,11511600000,11533600000,22000000,293,0,1
Aureliano Adami,andiamo,2,11887600000,11899200000,11600000,299,0,1
Aureliano Adami,oh,2,11887600000,11899200000,11600000,300,0,1
Aureliano Adami,ho risolto andiamo,2,11912400000,11926000000,13600000,301,0,1
Sara Monaschi,te l ho detto hanno caricato un pezzo di video col prete alla festa,2,11977200000,12016000000,38800000,302,0,0
Sara Monaschi,e la ragazza,2,12016800000,12028800000,12000000,303,0,0
Sara Monaschi,ma che vuol dire,2,12044800000,12056800000,12000000,304,0,0
Gabriele Marchilli,che non si trova che se n è andata,2,12057600000,12077600000,20000000,305,0,1
Gabriele Marchilli,questo vuol dire,2,12083200000,12092800000,9600000,306,0,1
Sara Monaschi,e tu trovala,2,12093600000,12107200000,13600000,307,0,0
Sara Monaschi,capito la devi trovare,2,12108000000,12126400000,18400000,308,0,0
Sara Monaschi,hanno messo il video in rete,2,12165600000,12184000000,18400000,309,0,0
Sara Monaschi,per ora senza che si veda la faccia di theodosiou,2,12184800000,12209600000,24800000,310,0,0
Sara Monaschi,ma se non paga la mettono tutta,2,12210400000,12226800000,16400000,311,0,0
Sara Monaschi,non lo è,2,12261200000,12269600000,8400000,313,0,0
Sara Monaschi,hai alternative,2,12300400000,12309600000,9200000,315,0,0
Sara Monaschi,ce le hai,2,12310400000,12322800000,12400000,316,0,0
Amedeo Cinaglia,allora cosa,2,12564000000,12577200000,13200000,318,0,1
Amedeo Cinaglia,è già definito,2,12578000000,12602000000,24000000,320,0,1
Amedeo Cinaglia,certo hanno tutti fretta di chiudere i loro affari adesso no,2,12662800000,12694800000,32000000,323,0,1
Amedeo Cinaglia,da quand è che ti occupi di politica,2,12751600000,12792400000,40800000,326,0,1
Amedeo Cinaglia,hai visto finucci,2,12944400000,12964000000,19600000,333,0,1
Amedeo Cinaglia,quanto le dà,2,13122800000,13132000000,9200000,336,0,1
Amedeo Cinaglia,samurai quanto le dà,2,13169200000,13184400000,15200000,338,0,1
Amedeo Cinaglia,allora,2,13237200000,13245600000,8400000,339,0,1
Amedeo Cinaglia,gli altri consiglieri stanno pure loro sul libro paga,2,13288800000,13316400000,27600000,341,0,1
Amedeo Cinaglia,potrei far sapere la cosa,2,13394800000,13408000000,13200000,345,0,1
Amedeo Cinaglia,far scoppiare uno scandalo,2,13421200000,13438000000,16800000,346,0,1
Amedeo Cinaglia,che rimarrà a verbale,2,13629600000,13642400000,12800000,352,0,1
Amedeo Cinaglia,così lei avrà un alibi,2,13654000000,13666400000,12400000,353,0,1
Sara Monaschi,non c è più molto tempo,2,13898800000,13912400000,13600000,357,0,0
Sara Monaschi,quindi mi ascolti bene,2,13919200000,13936400000,17200000,358,0,0
Sara Monaschi,andrò io all appuntamento al posto suo e risolverò tutto,2,13950000000,13977600000,27600000,359,0,0
Sara Monaschi,in cambio però voglio che lei esca di qui e venga in commissione alle 20 00,2,13981200000,14015600000,34400000,360,0,0
Sara Monaschi,dove farà votare tutti come ci siamo messi d accordo,2,14016400000,14044000000,27600000,361,0,0
Sara Monaschi,va bene,2,14060400000,14068800000,8400000,362,0,0
Sara Monaschi,ci vediamo alle 20 00,2,14117200000,14134400000,17200000,364,0,0
Livia Adami,nessuna quota l affare è più grosso,2,14167200000,14209200000,42000000,366,0,0
Livia Adami,riguarda la terra che vedi e tutto quello che ci sta intorno,2,14210000000,14236800000,26800000,367,0,0
Livia Adami,ci faranno un porto,2,14237600000,14252000000,14400000,368,0,0
Livia Adami,la mia famiglia avrà parte della coca che arriva,2,14252800000,14278800000,26000000,369,0,0
Livia Adami,tonnellate di coca,2,14279600000,14294400000,14800000,370,0,0
Livia Adami,no mio padre non glielo vuole dire,2,14307200000,14347200000,40000000,372,0,0
Livia Adami,pensa che aureliano qua ci voleva fare lo stabilimento,2,14445200000,14475600000,30400000,373,0,0
Livia Adami,non ti mettere in mezzo ezio,2,14507200000,14523200000,16000000,375,0,0
Livia Adami,forse è un po troppo,2,14578400000,14591200000,12800000,377,0,0
Livia Adami,che c è,2,14663200000,14672000000,8800000,379,0,0
Livia Adami,no,2,14695600000,14704400000,8800000,380,0,0
Livia Adami,non si può fare,2,14739200000,14761200000,22000000,382,0,0
Livia Adami,perché no,2,14773600000,14784000000,10400000,384,0,0
Livia Adami,e questo,2,14820400000,14832800000,12400000,385,0,0
Livia Adami,è legato,2,14885600000,14895200000,9600000,387,0,0
Livia Adami,ehi piccolino,2,14917200000,14930400000,13200000,389,0,0
Livia Adami,ciao,2,14952400000,14963200000,10800000,390,0,0
Manfredi Anacleti,boris,2,15048400000,15058000000,9600000,392,0,1
Manfredi Anacleti,girate tutto il mondo,2,15114000000,15132000000,18000000,394,0,1
Manfredi Anacleti,voglio sapere che fine ha fatto,2,15152400000,15170800000,18400000,395,0,1
Aureliano Adami,le guardie non ci stanno,2,15397200000,15414800000,17600000,396,0,1
Alberto Anacleti,te l ho detto zio prete ha smaltito,2,15424800000,15446400000,21600000,397,0,1
Alberto Anacleti,vedrai mo come viene a cuccia,2,15458000000,15477200000,19200000,398,0,1
Alberto Anacleti,oh che hai fatto,2,15498400000,15518000000,19600000,399,0,1
Alberto Anacleti,è un ora che stai zitto,2,15518800000,15550000000,31200000,400,0,1
Aureliano Adami,avrà digerito male,2,15518800000,15550000000,31200000,401,0,1
Gabriele Marchilli,guarda che è ora,2,15566000000,15578000000,12000000,402,0,1
Alberto Anacleti,hai fretta di vedere i soldi,2,15584800000,15619600000,34800000,403,0,1
Gabriele Marchilli,no ho fretta di finire sta storia,2,15584800000,15619600000,34800000,404,0,1
Aureliano Adami,guarda che ti controllo,2,15639600000,15656000000,16400000,405,0,1
Alberto Anacleti,hai paura che ti frego i soldi mmh,2,15667600000,15691200000,23600000,406,0,1
Aureliano Adami,sei sempre uno zingaro,2,15692000000,15711200000,19200000,407,0,1
Gabriele Marchilli,io non vi capisco per voi è tutto un gioco,2,15815600000,15844400000,28800000,408,0,1
Aureliano Adami,è meglio divertirsi quando si lavora fratello,2,15882400000,15906400000,24000000,409,0,1
Aureliano Adami,questa chi cazzo è,2,16042000000,16054400000,12400000,410,1,1
Aureliano Adami,la conosci,2,16083600000,16094000000,10400000,411,0,1
Gabriele Marchilli,è sara quella della festa,2,16094800000,16111600000,16800000,412,0,1
Aureliano Adami,e il prete dove sta,2,16122000000,16137600000,15600000,413,0,1
Alberto Anacleti,ma che è uno scherzo,2,16324800000,16336800000,12000000,414,0,1
Alberto Anacleti,questi non sono neanche un decimo,2,16343600000,16358000000,14400000,415,0,1
Alberto Anacleti,diciamo che è un acconto,2,16363600000,16377200000,13600000,416,0,1
Sara Monaschi,no diciamo che è tutto,2,16378000000,16392000000,14000000,417,0,0
Sara Monaschi,è tutto quello che ha il prete,2,16401200000,16418400000,17200000,418,0,0
Alberto Anacleti,bella non hai capito,2,16428000000,16438800000,10800000,419,0,1
Alberto Anacleti,mo vai dallo stronzo e gli dici che se non mi dà tutti i soldi,2,16439600000,16467200000,27600000,420,1,1
Alberto Anacleti,la sua faccia finisce dappertutto,2,16468000000,16485200000,17200000,421,0,1
Alberto Anacleti,ti è chiaro o te lo scrivo,2,16486000000,16499200000,13200000,422,0,1
Sara Monaschi,tu mettilo in rete e la polizia ti traccia dopo cinque minuti,2,16500000000,16529600000,29600000,423,0,0
Alberto Anacleti,la storia non finisce qua,2,16598800000,16629600000,30800000,424,0,1
Sara Monaschi,io dico di sì invece,2,16598800000,16629600000,30800000,425,0,0
Aureliano Adami,ma che vuol dire,2,16838800000,16853200000,14400000,426,0,1
Alberto Anacleti,è quello che m ha dato dice che questo c ha il prete,2,16862400000,16889600000,27200000,427,0,1
Gabriele Marchilli,dove cazzo va quello,2,16980400000,16996400000,16000000,428,1,1
Aureliano Adami,dove sta,2,17555600000,17565600000,10000000,429,0,1
Aureliano Adami,sorella il prete dove cazzo sta,2,17627200000,17646800000,19600000,430,1,1
Aureliano Adami,dove cazzo sta,2,17654800000,17688800000,34000000,431,1,1
Aureliano Adami,tie e ringrazia l amica tua stupido,2,17781600000,17805200000,23600000,433,0,1
Gabriele Marchilli,abbiamo ancora il video no,2,17815200000,17830800000,15600000,434,0,1
Aureliano Adami,forse non hai capito te lo rispiego,2,17853600000,17872400000,18800000,435,0,1
Aureliano Adami,il prete se n è andato e non si sa dov è col video ti ci fai le pippe,2,17873200000,17910000000,36800000,436,0,1
Aureliano Adami,metti sto cazzo di video su internet così al prete passa la voglia di scopare,2,17912400000,17951200000,38800000,437,1,1
Gabriele Marchilli,che cazzo ci faccio solo con questi,2,18143600000,18165200000,21600000,438,1,1
Gabriele Marchilli,sono fottuto,2,18214400000,18224400000,10000000,439,1,1
Samurai Valerio,bravi sti ragazzini,2,18402000000,18416800000,14800000,441,0,1
Samurai Valerio,ricorda il giorno in cui ha smesso di sognare di essere un campione,2,18517200000,18546800000,29600000,442,0,1
Amedeo Cinaglia,io non ci giocavo a pallone,2,18558800000,18573200000,14400000,443,0,1
Amedeo Cinaglia,farò cambiare l ordine del giorno,2,18608800000,18628000000,19200000,444,0,1
Amedeo Cinaglia,farò in modo che la pratica su ostia venga discussa per prima,2,18639600000,18664000000,24400000,445,0,1
Amedeo Cinaglia,solo questo farò sia chiaro,2,18664800000,18683600000,18800000,446,0,1
Amedeo Cinaglia,solo questo voglio,2,18689200000,18699200000,10000000,447,0,1
Samurai Valerio,il costo,2,18707200000,18717600000,10400000,448,0,1
Amedeo Cinaglia,lei pagherà la mia campagna elettorale,2,18727600000,18750000000,22400000,449,0,1
Amedeo Cinaglia,voglio essere il primo degli eletti,2,18767200000,18786000000,18800000,450,0,1
Samurai Valerio,faccia quello che le ho chiesto,2,18818000000,18832400000,14400000,451,0,1
Samurai Valerio,vedrà sarò molto generoso,2,18833200000,18864400000,31200000,452,0,1
Amedeo Cinaglia,a chi andranno i terreni di ostia,2,18872800000,18891600000,18800000,453,0,1
Samurai Valerio,stia attento questo gioco potrebbe piacerle,2,18901200000,18932400000,31200000,454,0,1
Samurai Valerio,buon lavoro,2,18958800000,18971200000,12400000,455,0,1
Gabriele Marchilli,sono 10 000,2,19207600000,19224400000,16800000,458,0,1
Gabriele Marchilli,venti,2,19248000000,19256400000,8400000,461,0,1
Gabriele Marchilli,giuro che te li porto domani,2,19257200000,19282400000,25200000,463,0,1
Samurai Valerio,tutto bene ragazzino,2,19550000000,19562000000,12000000,467,0,1
Gabriele Marchilli,tutto bene,2,19596000000,19604400000,8400000,468,0,1
Samurai Valerio,chi cazzo è,2,19676000000,19686000000,10000000,469,1,1
Aureliano Adami,ciao ro,2,19851200000,19865600000,14400000,471,0,1
Aureliano Adami,dove sta,2,19866400000,19886800000,20400000,474,0,1
Livia Adami,sono stata al chiosco,2,19992800000,20005200000,12400000,476,0,0
Aureliano Adami,e com è,2,20024000000,20035600000,11600000,477,0,1
Aureliano Adami,papà ha cambiato idea,2,20047200000,20060800000,13600000,478,0,1
Livia Adami,di chi è il cane,2,20071600000,20082000000,10400000,479,0,0
Aureliano Adami,è mio l ho trovato per strada che mi devi dire,2,20082800000,20107600000,24800000,480,0,1
Livia Adami,ha ragione papà,2,20122400000,20133600000,11200000,481,0,0
Livia Adami,il chiosco non conviene ci vogliono troppi soldi,2,20141600000,20167200000,25600000,482,0,0
Aureliano Adami,chi lo dice quirino,2,20182400000,20197200000,14800000,483,0,1
Aureliano Adami,quello deve fare i conti e basta già te l ho detto livia,2,20213200000,20237600000,24400000,484,0,1
Livia Adami,li fa e pure bene,2,20238400000,20266000000,27600000,485,0,0
Aureliano Adami,pure qualcos altro dovrebbe fare bene,2,20238400000,20266000000,27600000,486,0,1
Livia Adami,ho dovuto mandare romolo a fare il lavoro tuo,2,20294400000,20315200000,20800000,487,0,0
Livia Adami,papà non se ne accorge ma ci devi pensare te,2,20316000000,20340000000,24000000,488,0,0
Aureliano Adami,non si può pensare sempre e solo ai soldi livia,2,20376000000,20400400000,24400000,489,0,1
Livia Adami,infatti penso pure a parare le cazzate tue,2,20401200000,20423200000,22000000,490,1,0
Livia Adami,e pure a tenere unita la famiglia,2,20432800000,20450000000,17200000,491,0,0
Aureliano Adami,te a che pensi invece,2,20484400000,20499600000,15200000,492,0,1
Aureliano Adami,ma perché non abbiamo mai avuto un cane noi,2,20525200000,20547600000,22400000,493,0,1
Aureliano Adami,eh,2,20553200000,20561599999,8399999,494,0,1
Livia Adami,perché non abbiamo mai avuto un cane,2,20593600000,20612399999,18799999,495,0,0
Livia Adami,a papà non piacevano a mamma sì,2,20626399999,20644800000,18400001,496,0,0
Aureliano Adami,strano,2,20649200000,20657600000,8400000,497,0,1
Livia Adami,tu assomigli sempre di più a mamma,2,20682800000,20702800000,20000000,498,0,0
Livia Adami,comunque il cane è un amore,2,20764000000,20779600000,15600000,499,0,0
Livia Adami,portalo a casa che facciamo un dispetto a papà,2,20784800000,20809200000,24400000,500,0,0
Alberto Anacleti,che cazzo fai,2,21059200000,21070000000,10800000,501,1,1
Angelica Sale,m hai lasciato al locale tuo come una povera stronza,2,21070800000,21093200000,22400000,502,1,0
Alberto Anacleti,ho avuto una giornata di merda,2,21094000000,21130000000,36000000,503,1,1
Angelica Sale,non mi faccio trattare così da nessuno,2,21094000000,21130000000,36000000,504,0,0
Angelica Sale,e non ti far più vedere,2,21144400000,21159600000,15200000,505,0,0
Alberto Anacleti,vattene a fanculo,2,21167200000,21188800000,21600000,506,1,1
Angelica Sale,vaffanculo te,2,21167200000,21188800000,21600000,507,1,0
Manfredi Anacleti,ehi dove scappi,2,21212000000,21223200000,11200000,508,0,1
Manfredi Anacleti,senti un po,2,21277200000,21292400000,15200000,509,0,1
Manfredi Anacleti,che è successo,2,21327200000,21335600000,8400000,510,0,1
Alberto Anacleti,niente e comunque sono cazzi miei,2,21348400000,21372800000,24400000,511,1,1
Manfredi Anacleti,ah,2,21348400000,21372800000,24400000,512,0,1
Manfredi Anacleti,guarda che i cazzi tuoi dentro a sta casa non esistono spadi,2,21378400000,21407200000,28800000,513,1,1
Manfredi Anacleti,bisogna che te lo ricordi,2,21408000000,21422800000,14800000,514,0,1
Sara Monaschi,guarda che non è cambiato niente qua,2,21681600000,21700800000,19200000,516,0,0
Sara Monaschi,anch io non ci mettevo piede da tre mesi,2,21706800000,21728800000,22000000,517,0,0
Sara Monaschi,senti io devo andare in vaticano ho un po fretta,2,21764400000,21788400000,24000000,518,0,0
Sara Monaschi,che mi volevi dire tu,2,21796800000,21808400000,11600000,519,0,0
Gabriele Marchilli,la ragazza non l ho trovata,2,21820800000,21841200000,20400000,520,0,1
Sara Monaschi,non importa,2,21842000000,21853600000,11600000,521,0,0
Sara Monaschi,tanto ho risolto,2,21859200000,21872000000,12800000,522,0,0
Gabriele Marchilli,come,2,21872800000,21882400000,9600000,523,0,1
Sara Monaschi,ho pagato,2,21890400000,21900000000,9600000,524,0,0
Sara Monaschi,non quello che chiedevano loro,2,21909600000,21926000000,16400000,525,0,0
Gabriele Marchilli,il prete sta ancora in clinica,2,22016400000,22032400000,16000000,526,0,1
Sara Monaschi,no l hanno dimesso,2,22038800000,22056800000,18000000,527,0,0
Gabriele Marchilli,quindi è già tornato a casa,2,22061600000,22076400000,14800000,528,0,1
Gabriele Marchilli,sta bene,2,22082000000,22099600000,17600000,529,0,1
Sara Monaschi,sì si è ripreso,2,22082000000,22099600000,17600000,530,0,0
Sara Monaschi,abbastanza,2,22100400000,22112800000,12400000,531,0,0
Sara Monaschi,lo vedo tra un ora in commissione,2,22134000000,22150000000,16000000,532,0,0
Sara Monaschi,oh comunque domani ti chiamo che ti devo ancora pagare,2,22181200000,22210800000,29600000,533,0,0
Sara Monaschi,non mi sono mica dimenticata,2,22228800000,22245200000,16400000,534,0,0
Gabriele Marchilli,sei bellissima,2,22299600000,22315600000,16000000,535,0,1
Sara Monaschi,senti mi dispiace per stamattina,2,22366400000,22391200000,24800000,536,0,0
Gabriele Marchilli,lascia perdere,2,22392000000,22402800000,10800000,537,0,1
Sara Monaschi,tirati dietro la porta ciao,2,22494000000,22517200000,23200000,538,0,0
Sara Monaschi,ciao,2,22518000000,22526400000,8400000,539,0,0
Gabriele Marchilli,hai già messo in rete tutto il video,2,22628800000,22647600000,18800000,541,0,1
Gabriele Marchilli,ecco non farlo,2,22657600000,22667200000,9600000,542,0,1
Gabriele Marchilli,so dov è il prete,2,22679600000,22690800000,11200000,543,0,1
Sara Monaschi,buonasera eminenza il monsignore sta arrivando,2,22821200000,22856000000,34800000,547,0,0
Aureliano Adami,zio prete,2,23098800000,23108000000,9200000,549,0,1
Aureliano Adami,ammazza come sta in forma,2,23144800000,23176400000,31600000,550,0,1
Alberto Anacleti,s è ripreso in fretta l amico,2,23144800000,23176400000,31600000,551,0,1
Aureliano Adami,dove vai zio prete vieni qua,2,23177200000,23192800000,15600000,552,0,1
Aureliano Adami,vogliamo solo chiacchierare con te,2,23221600000,23238400000,16800000,553,0,1
Aureliano Adami,non vuoi chiacchierare,2,23249600000,23260000000,10400000,554,0,1
Aureliano Adami,facciamo il giro,2,23299600000,23309600000,10000000,555,0,1
Sara Monaschi,perdonatemi un secondo,2,24055600000,24071200000,15600000,562,0,0
Sara Monaschi,pronto,2,24076800000,24085600000,8800000,563,0,0
Sara Monaschi,lei dove si trova in questo momento,2,24137600000,24157200000,19600000,566,0,0
Sara Monaschi,l hanno vista entrare,2,24189600000,24219200000,29600000,568,0,0
Sara Monaschi,adesso mi ascolti si calmi,2,24235600000,24261200000,25600000,571,0,0
Sara Monaschi,adesso lei deve andare a casa chiuda la porta e non apra a nessuno,2,24266800000,24303200000,36400000,572,0,0
Sara Monaschi,il monsignor theodosiou si scusa ma ha avuto un imprevisto,2,24562400000,24595600000,33200000,573,0,0
Sara Monaschi,la riunione va rimandata,2,24596400000,24626400000,30000000,574,0,0
Sara Monaschi,nulla che non si possa risolvere eminenza,2,24627200000,24646400000,19200000,576,0,0
Aureliano Adami,ahó,2,24808000000,24817200000,9200000,579,0,1
Gabriele Marchilli,l ho trovato,2,24818000000,24828000000,10000000,580,0,1
Gabriele Marchilli,tornate indietro,2,24838800000,24849600000,10800000,581,0,1
Aureliano Adami,ma che cazzo sta a fare,2,25160400000,25171200000,10800000,585,1,1
Aureliano Adami,zitto non ti muovere che ti sparo in faccia,2,25325200000,25355200000,30000000,589,0,1
Aureliano Adami,mi sa che non ti sei pentito abbastanza zio prete,2,25458000000,25481200000,23200000,590,0,1
Aureliano Adami,dai continua,2,25493600000,25507600000,14000000,591,0,1
Aureliano Adami,dai,2,25530800000,25539200000,8400000,592,0,1
Alberto Anacleti,quanto hai in banca,2,25588800000,25605200000,16400000,596,0,1
Alberto Anacleti,t ho chiesto quanto hai in banca,2,25622800000,25644400000,21600000,597,0,1
Alberto Anacleti,non dire cazzate,2,25666800000,25676400000,9600000,599,1,1
Alberto Anacleti,sei il capo della commissione quindi puoi andare in banca e chiedere i soldi,2,25690000000,25732800000,42800000,600,0,1
Alberto Anacleti,mmh,2,25733600000,25742000000,8400000,601,0,1
Alberto Anacleti,i 300 000 li puoi chiedere,2,25783600000,25800800000,17200000,602,0,1
Alberto Anacleti,oh,2,25814800000,25823600000,8800000,603,0,1
Aureliano Adami,mo te vieni con noi,2,25911600000,25924400000,12800000,605,0,1
Aureliano Adami,così non fai altre cazzate,2,25930800000,25944800000,14000000,606,1,1
Aureliano Adami,domani mattina mandi qualcuno a prendere i soldi e ce li dai,2,25957600000,25989600000,32000000,607,0,1
Aureliano Adami,e noi ci scordiamo di te,2,25996000000,26010400000,14400000,608,0,1
Aureliano Adami,hai capito,2,26029600000,26038000000,8400000,609,0,1
Aureliano Adami,dai,2,26590800000,26599600000,8800000,611,0,1
Alberto Anacleti,qua in fondo a destra,2,26600400000,26615200000,14800000,612,0,1
Aureliano Adami,vieni qua,2,26683600000,26692000000,8400000,613,0,1
Aureliano Adami,non fare cazzate zio prete,2,26804000000,26816800000,12800000,614,1,1
Sara Monaschi,monsignore,2,27060800000,27073600000,12800000,615,0,0
Sara Monaschi,monsignore,2,27092000000,27103600000,11600000,616,0,0
Sara Monaschi,monsignore,2,27203600000,27217600000,14000000,617,0,0
Gabriele Marchilli,è sicuro qui eh,2,27239200000,27253200000,14000000,619,0,1
Alberto Anacleti,tranquillo tanto anche se strilla non lo sente nessuno,2,27261200000,27296800000,35600000,620,0,1
Alberto Anacleti,oh ragazzi,2,27315600000,27324000000,8400000,621,0,1
Alberto Anacleti,sta musica spacca,2,27330400000,27351200000,20800000,622,0,1
Alberto Anacleti,te che fai le,2,27374800000,27392800000,18000000,623,0,1
Alberto Anacleti,non balli,2,27393600000,27406000000,12400000,624,0,1
Gabriele Marchilli,dai smettila,2,27406800000,27421200000,14400000,625,0,1
Aureliano Adami,com è che non balli le,2,27422000000,27438000000,16000000,626,0,1
Aureliano Adami,non ti viene voglia di ballare guarda,2,27438800000,27465200000,26400000,627,0,1
Alberto Anacleti,facciamo un brindisi eh,2,27519600000,27536000000,16400000,629,0,1
Aureliano Adami,un altra volta c ho una cosa da fare,2,27545600000,27564000000,18400000,630,0,1
Aureliano Adami,ci vediamo domattina,2,27574400000,27586000000,11600000,631,0,1
Alberto Anacleti,dai prendi due bicchieri,2,27608800000,27624400000,15600000,632,0,1
Aureliano Adami,perché fai la puttana,2,28685200000,28698000000,12800000,641,1,1
Aureliano Adami,voglio sapere dove sei nata,2,28782000000,28796800000,14800000,644,0,1
Aureliano Adami,va bene,2,28958000000,28968000000,10000000,646,0,1
Aureliano Adami,allora se non vuoi parlare me ne vado,2,29013200000,29030800000,17600000,647,0,1
Samurai Valerio,dott ssa monaschi,3,1152400000,1169600000,17200000,4,0,1
Samurai Valerio,perché mi ha chiamato,3,1178400000,1192800000,14400000,5,0,1
Sara Monaschi,hanno rapito uno dei preti della commissione vaticana,3,1221600000,1245600000,24000000,6,0,0
Sara Monaschi,e lo stanno ricattando,3,1246400000,1258000000,11600000,7,0,0
Sara Monaschi,lei può ritrovarlo,3,1265200000,1278000000,12800000,8,0,0
Samurai Valerio,e se lo ritrovo,3,1323200000,1338400000,15200000,9,0,1
Sara Monaschi,i terreni di ostia,3,1357200000,1369200000,12000000,10,0,0
Sara Monaschi,cinquanta e cinquanta,3,1386400000,1397200000,10800000,11,0,0
Aureliano Adami,non ti volevo svegliare,3,2072800000,2084000000,11200000,13,0,1
Aureliano Adami,non ti bastano,3,2174400000,2185200000,10800000,14,0,1
Aureliano Adami,per stanotte e per farti scordare quello che hai visto,3,2212400000,2235200000,22800000,16,0,1
Aureliano Adami,compraci un bel vestito tie,3,2432400000,2452800000,20400000,19,0,1
Aureliano Adami,la prossima volta ti ci voglio vedere,3,2465600000,2483600000,18000000,20,0,1
Gabriele Marchilli,dai che è tardi,3,2747600000,2758800000,11200000,23,0,1
Aureliano Adami,guarda che il monsignore non si muove,3,2772400000,2794400000,22000000,24,0,1
Aureliano Adami,ma che ti guardi oh,3,2835600000,2847200000,11600000,25,0,1
Gabriele Marchilli,niente,3,2859200000,2867600000,8400000,26,0,1
Gabriele Marchilli,sono contento che non l hai ammazzata,3,2879600000,2899600000,20000000,27,0,1
Aureliano Adami,sarebbe stato uno spreco gabrie,3,2921200000,2941200000,20000000,28,0,1
Alberto Anacleti,ciao nazare salve,3,2992000000,3013600000,21600000,29,0,1
Alberto Anacleti,se cerchi mio fratello sta a casa,3,3200400000,3219200000,18800000,30,0,1
Samurai Valerio,non cerco manfredi mi servi te,3,3220000000,3238800000,18800000,31,0,1
Samurai Valerio,sei spadino no,3,3248400000,3262000000,13600000,32,0,1
Samurai Valerio,come vanno gli affari,3,3289200000,3302000000,12800000,33,0,1
Alberto Anacleti,vanno bene perché,3,3322800000,3336000000,13200000,34,0,1
Samurai Valerio,ma tu che affari hai spadi,3,3344000000,3362000000,18000000,35,0,1
Alberto Anacleti,cose di famiglia,3,3387600000,3401200000,13600000,36,0,1
Samurai Valerio,cioè lo strozzo un po di spaccio le solite cazzate di voi zingari,3,3404800000,3446000000,41200000,37,1,1
Samurai Valerio,com è che sei venuto a rompere i coglioni a me,3,3450000000,3470000000,20000000,38,1,1
Alberto Anacleti,di che parli,3,3503600000,3512000000,8400000,39,0,1
Samurai Valerio,stai ricattando un prete,3,3512800000,3524800000,12000000,40,0,1
Samurai Valerio,l hai fatto pure spari,3,3528800000,3540800000,12000000,41,0,1
Samurai Valerio,cazzo fai gli impicci fuori dalla famiglia,3,3548800000,3566400000,17600000,42,1,1
Alberto Anacleti,e se anche fosse,3,3598400000,3612000000,13600000,43,0,1
Alberto Anacleti,non sono problemi tuoi mi pare no,3,3618800000,3638400000,19600000,44,0,1
Samurai Valerio,e invece sì se no non venivo a parlare con uno come te,3,3639200000,3664800000,25600000,45,0,1
Samurai Valerio,dove sta sto prete,3,3671200000,3683600000,12400000,46,0,1
Alberto Anacleti,senti però vediamo di metterci d accordo,3,3745200000,3765200000,20000000,47,0,1
Alberto Anacleti,perché io ci devo alzare bei soldi col prete,3,3773200000,3793600000,20400000,48,0,1
Samurai Valerio,libera il prete,3,3813600000,3826400000,12800000,49,0,1
Samurai Valerio,adesso,3,3845200000,3854000000,8800000,50,0,1
Amedeo Cinaglia,sì ora vado,3,4081600000,4093600000,12000000,53,0,1
Amedeo Cinaglia,ciao hai sonno,3,4107600000,4120400000,12800000,54,0,1
Amedeo Cinaglia,ciao tesoro,3,4130400000,4139600000,9200000,55,0,1
Alberto Anacleti,vattene,3,4790000000,4799600000,9600000,60,0,1
Alberto Anacleti,che cazzo non senti t ho detto vattene,3,4821600000,4849600000,28000000,61,1,1
Alberto Anacleti,sto sorcio li mortacci sua,3,4916800000,4936800000,20000000,62,0,1
Aureliano Adami,come sta il prete,3,5391600000,5400800000,9200000,63,0,1
Aureliano Adami,beh,3,5451600000,5460400000,8800000,64,0,1
Alberto Anacleti,l ho dovuto liberare,3,5498400000,5509200000,10800000,65,0,1
Aureliano Adami,che hai detto,3,5525600000,5534000000,8400000,66,0,1
Alberto Anacleti,è venuto da me samurai stamattina,3,5538400000,5557200000,18800000,67,0,1
Aureliano Adami,levati,3,5580800000,5590800000,10000000,68,0,1
Gabriele Marchilli,ma come è venuto samurai,3,5602400000,5614000000,11600000,69,0,1
Gabriele Marchilli,che t ha detto,3,5620400000,5628800000,8400000,70,0,1
Alberto Anacleti,sapeva tutto che avevamo il prete e lo stavamo ricattando,3,5629600000,5655200000,25600000,71,0,1
Gabriele Marchilli,sapeva di tutti e tre,3,5656000000,5687200000,31200000,72,0,1
Alberto Anacleti,di voi non sapeva un cazzo,3,5656000000,5687200000,31200000,73,1,1
Aureliano Adami,ti rendi conto di che cazzo hai fatto,3,5727600000,5744800000,17200000,74,1,1
Alberto Anacleti,che cazzo dovevo fare,3,5745600000,5777200000,31600000,75,1,1
Aureliano Adami,non ti dovevi cacare addosso,3,5745600000,5777200000,31600000,76,1,1
Aureliano Adami,dovevi prima parlare con me,3,5778000000,5794800000,16800000,77,0,1
Aureliano Adami,ti sei inchinato davanti a quel pezzo di merda non ci posso credere,3,5829600000,5861600000,32000000,78,1,1
Aureliano Adami,la colpa è la mia,3,5880800000,5890800000,10000000,79,0,1
Aureliano Adami,mi metto a fare gli impicci con questo che è figlio di una guardia,3,5891600000,5920800000,29200000,80,0,1
Aureliano Adami,e con te che sei uno zingaro di merda,3,5921600000,5947200000,25600000,81,1,1
Aureliano Adami,come tuo fratello,3,5948000000,5961200000,13200000,82,0,1
Aureliano Adami,però almeno quello è un uomo,3,5964400000,5987200000,22800000,83,0,1
Alberto Anacleti,ma vattene affanculo,3,5964400000,5987200000,22800000,84,1,1
Aureliano Adami,pezzo di merda,3,5988000000,6004400000,16400000,85,1,1
Gabriele Marchilli,aurelia,3,5988000000,6004400000,16400000,86,0,1
Alberto Anacleti,che cazzo vuoi fare eh,3,6026000000,6041200000,15200000,88,1,1
Alberto Anacleti,mi vuoi ammazzare,3,6056000000,6066400000,10400000,89,0,1
Alberto Anacleti,e ammazzami,3,6084000000,6095200000,11200000,90,0,1
Aureliano Adami,io non vi voglio più vedere,3,6214000000,6227600000,13600000,91,0,1
Alberto Anacleti,no,3,6366800000,6386800000,20000000,92,0,1
Amedeo Cinaglia,voglio una modifica sull ordine del giorno della commissione di oggi ecco,3,6527600000,6562800000,35200000,94,0,1
Amedeo Cinaglia,no ma io sono il presidente è una mia prerogativa,3,6618400000,6642800000,24400000,96,0,1
Amedeo Cinaglia,stampi pure le copie e le consegni,3,6664400000,6682400000,18000000,97,0,1
Amedeo Cinaglia,grazie,3,6683200000,6693600000,10400000,98,0,1
Alberto Anacleti,tu che cazzo stai a fare ancora qua,3,7067200000,7083200000,16000000,102,1,1
Gabriele Marchilli,senti spadi,3,7095200000,7106000000,10800000,103,0,1
Gabriele Marchilli,non è che avresti 30 000 euro,3,7130400000,7144400000,14000000,104,0,1
Alberto Anacleti,ma vattene affanculo pure te,3,7154000000,7175600000,21600000,105,1,1
Sara Monaschi,adesso è tutto finito può stare tranquillo,3,7380000000,7404000000,24000000,106,0,0
Sara Monaschi,mi dispiace per quello che è successo,3,7548000000,7565600000,17600000,112,0,0
Sara Monaschi,lei ha ragione è una cosa bruttissima lo capisco,3,7575200000,7608400000,33200000,113,0,0
Sara Monaschi,adesso però è necessario che lei convochi la commissione,3,7648800000,7683600000,34800000,114,0,0
Sara Monaschi,certo lo so,3,7723200000,7734800000,11600000,116,0,0
Sara Monaschi,non glielo chiederei se non fosse necessario,3,7735600000,7758400000,22800000,117,0,0
Sara Monaschi,ma è l ultimo passo,3,7767200000,7780800000,13600000,118,0,0
Amedeo Cinaglia,sì,3,7916800000,7925200000,8400000,121,0,1
Amedeo Cinaglia,e oggi invece l ho cambiato,3,7926000000,7954400000,28400000,123,0,1
Amedeo Cinaglia,motivi d urgenza,3,7955200000,7968800000,13600000,124,0,1
Amedeo Cinaglia,serri fa il bravo eh su,3,8014400000,8030400000,16000000,127,0,1
Samurai Valerio,come sta il monsignore,3,8103600000,8118000000,14400000,128,0,1
Sara Monaschi,bene,3,8134400000,8144400000,10000000,129,0,0
Samurai Valerio,è pronto per firmare,3,8156400000,8172400000,16000000,130,0,1
Sara Monaschi,sì ma prima dobbiamo parlare,3,8180800000,8202800000,22000000,131,0,0
Samurai Valerio,di che cosa dobbiamo parlare,3,8220400000,8234800000,14400000,132,0,1
Sara Monaschi,di quello che spetta alla società di mio marito,3,8251200000,8272800000,21600000,133,0,0
Sara Monaschi,avevamo detto di fare il 50 a testa no,3,8277600000,8301200000,23600000,134,0,0
Samurai Valerio,questo lo aveva detto lei,3,8317600000,8330400000,12800000,135,0,1
Samurai Valerio,però il problema del monsignore l ho risolto io,3,8331200000,8354400000,23200000,136,0,1
Samurai Valerio,ora deve dare tutto a me,3,8358000000,8373200000,15200000,137,0,1
Sara Monaschi,come tutto,3,8390800000,8401200000,10400000,138,0,0
Samurai Valerio,i terreni del vaticano passano a me,3,8408400000,8434000000,25600000,139,0,1
Samurai Valerio,se no i problemi del monsignore non sono finiti,3,8434800000,8456400000,21600000,140,0,1
Samurai Valerio,ci metto un attimo a far sapere tutto,3,8464800000,8482400000,17600000,141,0,1
Samurai Valerio,il vaticano deve vendere alla mia società,3,8498800000,8520000000,21200000,142,0,1
Sara Monaschi,ma avevamo un accordo,3,8583200000,8598400000,15200000,143,0,0
Sara Monaschi,lo sa da quant è che sto dietro a questo affare,3,8602000000,8623600000,21600000,144,0,0
Samurai Valerio,no e sinceramente non m interessa,3,8650800000,8675200000,24400000,145,0,1
Samurai Valerio,ha fatto male a venire qui,3,8684000000,8698000000,14000000,146,0,1
Samurai Valerio,guardi come si è ridotta le scarpe,3,8702400000,8719600000,17200000,147,0,1
Aureliano Adami,ciao more,3,9004000000,9020800000,16800000,148,0,1
Aureliano Adami,ma che è tutta sta gente,3,9065600000,9097600000,32000000,150,0,1
Aureliano Adami,no,3,9111200000,9119600000,8400000,152,0,1
Livia Adami,hanno trovato il cugino di manfredi ammazzato,3,9138800000,9165200000,26400000,153,0,0
Aureliano Adami,ah,3,9178400000,9186800000,8400000,154,0,1
Aureliano Adami,beh sti cazzi,3,9203200000,9214800000,11600000,155,1,1
Aureliano Adami,ahó t ho detto che non sono stato io,3,9272000000,9302800000,30800000,159,0,1
Aureliano Adami,ci cachiamo addosso pure con gli zingari così siamo messi,3,9320800000,9347600000,26800000,160,0,1
Aureliano Adami,avete capito voi,3,9405600000,9417200000,11600000,162,0,1
Angelica Sale,ciao,3,9742000000,9750400000,8400000,164,0,0
Alberto Anacleti,ciao,3,9777600000,9786000000,8400000,165,0,1
Angelica Sale,ho saputo di tuo cugino,3,9822000000,9837600000,15600000,166,0,0
Angelica Sale,com è successo,3,9886400000,9899200000,12800000,167,0,0
Alberto Anacleti,gli hanno aperto la faccia,3,9949600000,9965200000,15600000,168,0,1
Alberto Anacleti,gli hanno rotto gli zigomi la mascella e il naso,3,9979600000,10014400000,34800000,169,0,1
Alberto Anacleti,l hanno massacrato,3,10031200000,10046400000,15200000,170,0,1
Angelica Sale,e mo che succede,3,10110800000,10145600000,34800000,171,0,0
Alberto Anacleti,che cazzo vuoi che succeda ange,3,10110800000,10145600000,34800000,172,1,1
Alberto Anacleti,la guerra,3,10150800000,10161200000,10400000,173,0,1
Angelica Sale,mi giuri che stai attento spadi,3,10183600000,10200800000,17200000,174,0,0
Alberto Anacleti,ma che vuoi non avevi detto che non mi volevi più vedere,3,10210000000,10240000000,30000000,175,0,1
Angelica Sale,volevo solo sapere come stavi,3,10256400000,10291600000,35200000,176,0,0
Alberto Anacleti,m hai visto sto bene,3,10256400000,10291600000,35200000,177,0,1
Angelica Sale,va bene come non detto,3,10313199999,10328399999,15200000,178,0,0
Livia Adami,a me devi dire la verità,3,10560800000,10577600000,16800000,180,0,0
Livia Adami,di chi è sto cane,3,10632800000,10644800000,12000000,181,0,0
Aureliano Adami,mo è mio,3,10650800000,10660800000,10000000,182,0,1
Livia Adami,che cazzo hai fatto aurelia,3,10680000000,10696000000,16000000,183,1,0
Aureliano Adami,era solo uno zingaro di merda livia,3,10744000000,10767200000,23200000,184,1,1
Livia Adami,ma perché non me l hai detto,3,10777200000,10802400000,25200000,185,0,0
Aureliano Adami,e che ti dovevo dire,3,10777200000,10802400000,25200000,186,0,1
Livia Adami,che sei uno stronzo,3,10803200000,10819600000,16400000,187,1,0
Livia Adami,poi ti lamenti di papà,3,10826000000,10841200000,15200000,188,0,0
Livia Adami,adesso mi senti bene e fai quello che ti dico io,3,10851600000,10874800000,23200000,189,0,0
Livia Adami,primo sto cane deve sparire,3,10879600000,10895200000,15600000,190,0,0
Aureliano Adami,dove cazzo lo metto senza di me muore,3,10896000000,10914400000,18400000,191,1,1
Livia Adami,forse non ci siamo capiti,3,10915200000,10930800000,15600000,192,0,0
Livia Adami,te lo ripeto per l ultima volta aureliano,3,10935600000,10957600000,22000000,193,0,0
Livia Adami,con papà ti copro io ma tu devi fare sparire sto cane,3,10958400000,10984000000,25600000,194,0,0
Livia Adami,e poi te ne stai tranquillo,3,10987200000,10998400000,11200000,195,0,0
Livia Adami,fino a quando non abbiamo capito se t ha visto qualcuno,3,10999200000,11022800000,23600000,196,0,0
Livia Adami,intesi,3,11042800000,11051200000,8400000,197,0,0
Livia Adami,intesi,3,11086800000,11107200000,20400000,198,0,0
Aureliano Adami,intesi,3,11086800000,11107200000,20400000,199,0,1
Aureliano Adami,che c è,3,11140400000,11150800000,10400000,200,0,1
Manfredi Anacleti,aureliano adami è un animale,3,11184800000,11206000000,21200000,202,0,1
Manfredi Anacleti,l ha ammazzato a calci come un cane,3,11206800000,11230400000,23600000,203,0,1
Manfredi Anacleti,bisogna sparargli in faccia e sfigurarlo,3,11245200000,11268000000,22800000,204,0,1
Manfredi Anacleti,non lo deve riconoscere nemmeno il padre,3,11268800000,11286400000,17600000,205,0,1
Manfredi Anacleti,lo troviamo e lo leghiamo,3,11294400000,11310000000,15600000,206,0,1
Manfredi Anacleti,lo tiriamo fino a casa e lo lasciamo là,3,11320800000,11341600000,20800000,207,0,1
Aureliano Adami,non mi guardare così,3,11520000000,11534800000,14800000,208,0,1
Aureliano Adami,mmh,3,11546000000,11554400000,8400000,209,0,1
Aureliano Adami,mi dispiace,3,11626800000,11640000000,13200000,210,0,1
Contessa Sveva Della Rocca Croce,gli hai messo il monsignore su un piatto d argento che t aspettavi,3,12196400000,12231200000,34800000,213,0,0
Contessa Sveva Della Rocca Croce,che dividesse a metà,3,12238400000,12249200000,10800000,214,0,0
Contessa Sveva Della Rocca Croce,devi imparare a capire chi hai di fronte,3,12258400000,12281600000,23200000,215,0,0
Contessa Sveva Della Rocca Croce,comunque,3,12302000000,12310400000,8400000,216,0,0
Contessa Sveva Della Rocca Croce,hai fatto uno sbaglio ma puoi ancora rimediare,3,12311200000,12335600000,24400000,217,0,0
Sara Monaschi,e come,3,12336400000,12347200000,10800000,218,0,0
Contessa Sveva Della Rocca Croce,prendi tempo,3,12350800000,12364800000,14000000,219,0,0
Contessa Sveva Della Rocca Croce,allontana theodosiou da roma e da samurai,3,12374000000,12404400000,30400000,220,0,0
Contessa Sveva Della Rocca Croce,e rallenta le decisioni della commissione,3,12409600000,12432800000,23200000,221,0,0
Contessa Sveva Della Rocca Croce,e no cara,3,12435600000,12457600000,22000000,223,0,0
Contessa Sveva Della Rocca Croce,non va qua,3,12470000000,12481200000,11200000,224,0,0
Contessa Sveva Della Rocca Croce,questo so pure di chi è,3,12502400000,12518800000,16400000,225,0,0
Contessa Sveva Della Rocca Croce,conosci il dott finucci,3,12547200000,12565600000,18400000,226,0,0
Sara Monaschi,il consulente tecnico della commissione edilizia giusto,3,12569200000,12598000000,28800000,227,0,0
Contessa Sveva Della Rocca Croce,è il dirigente che controlla,3,12598800000,12613600000,14800000,228,0,0
Contessa Sveva Della Rocca Croce,che le società a cui vengono assegnati i terreni del nuovo piano regolatore,3,12614400000,12650000000,35600000,229,0,0
Contessa Sveva Della Rocca Croce,siano pulite,3,12650800000,12661200000,10400000,230,0,0
Contessa Sveva Della Rocca Croce,senza il suo parere favorevole la commissione non può approvare nulla,3,12665200000,12699600000,34400000,231,0,0
Contessa Sveva Della Rocca Croce,i traffici di samurai su ostia passano per lui,3,12702800000,12727200000,24400000,232,0,0
Contessa Sveva Della Rocca Croce,e infatti l ha messo a libro paga,3,12731600000,12749200000,17600000,233,0,0
Contessa Sveva Della Rocca Croce,ma ancora per poco gli ho preparato una bella sorpresa,3,12756800000,12784800000,28000000,234,0,0
Contessa Sveva Della Rocca Croce,il dott finucci sta per ricevere un avviso di garanzia,3,12797600000,12829600000,32000000,235,0,0
Contessa Sveva Della Rocca Croce,noi adesso proviamo a complicargli un po la vita,3,12836000000,12864800000,28800000,236,0,0
Contessa Sveva Della Rocca Croce,vieni ti faccio vedere,3,12878000000,12890000000,12000000,237,0,0
Contessa Sveva Della Rocca Croce,non sai quanti poveri aiuto con questo centro,3,12893600000,12921600000,28000000,238,0,0
Amedeo Cinaglia,allora ci siamo tutti no mi sembra di sì,3,12940400000,12964000000,23600000,239,0,1
Amedeo Cinaglia,possiamo iniziare,3,12964800000,12978800000,14000000,240,0,1
Amedeo Cinaglia,come sapete a ostia c è un progetto di accorpamento di due lotti,3,13022000000,13062400000,40400000,241,0,1
Amedeo Cinaglia,che prevede la costruzione di un porto,3,13063200000,13080800000,17600000,242,0,1
Sara Monaschi,deve lasciare roma,3,13627200000,13639600000,12400000,255,0,0
Sara Monaschi,subito,3,13642800000,13651200000,8400000,256,0,0
Sara Monaschi,lo so,3,13667600000,13697600000,30000000,258,0,0
Sara Monaschi,ma quelli potrebbero ripensarci,3,13702800000,13721600000,18800000,259,0,0
Sara Monaschi,è meglio sparire per un po di tempo,3,13727200000,13749200000,22000000,260,0,0
Sara Monaschi,forse lei non si rende bene conto del casino che ha combinato,3,13768800000,13802000000,33200000,262,0,0
Sara Monaschi,ecco appunto,3,13849200000,13861600000,12400000,264,0,0
Sara Monaschi,allora mi dia retta,3,13866800000,13878400000,11600000,265,0,0
Sara Monaschi,è bene che se ne vada da roma,3,13892000000,13909600000,17600000,266,0,0
Sara Monaschi,si faccia dimenticare,3,13913600000,13927200000,13600000,267,0,0
Sara Monaschi,finché tutti non si sono scordati di quello che è successo,3,13940000000,13968800000,28800000,268,0,0
Aureliano Adami,che cazzo vuoi ancora spadi,3,14382400000,14399200000,16800000,273,1,1
Alberto Anacleti,a casa mia stanno piangendo un morto,3,14444400000,14465200000,20800000,274,0,1
Alberto Anacleti,l hai ammazzato te,3,14507600000,14520400000,12800000,275,0,1
Aureliano Adami,non me lo chiedere spadi,3,14656400000,14669200000,12800000,276,0,1
Alberto Anacleti,invece te lo chiedo,3,14710400000,14722800000,12400000,277,0,1
Alberto Anacleti,non me lo vuoi dire aurelia,3,14806400000,14820800000,14400000,278,0,1
Aureliano Adami,sta storia non c entra un cazzo con noi non mettiamo in mezzo le famiglie,3,14876400000,14910800000,34400000,279,1,1
Aureliano Adami,ciao spadi,3,15094000000,15105200000,11200000,280,0,1
Amedeo Cinaglia,e di che,3,15599200000,15621200000,22000000,287,0,1
Gabriele Marchilli,sara,3,16114400000,16122800000,8400000,301,0,1
Sara Monaschi,ma sei matto c è mio marito a casa,3,16254400000,16282800000,28400000,302,0,0
Gabriele Marchilli,sto nei casini,3,16254400000,16282800000,28400000,303,0,1
Sara Monaschi,che succede,3,16333200000,16343600000,10400000,304,0,0
Gabriele Marchilli,devo dei soldi a uno,3,16350000000,16361600000,11600000,305,0,1
Gabriele Marchilli,tanti soldi,3,16367200000,16376400000,9200000,306,0,1
Sara Monaschi,quanto,3,16377200000,16388000000,10800000,307,0,0
Gabriele Marchilli,trentamila,3,16397200000,16407200000,10000000,308,0,1
Sara Monaschi,trentamila,3,16412000000,16422400000,10400000,309,0,0
Gabriele Marchilli,entro oggi,3,16428400000,16439200000,10800000,310,0,1
Sara Monaschi,ma io non ce li ho entro oggi poi ma perché non me l hai detto prima,3,16450800000,16491600000,40800000,311,0,0
Gabriele Marchilli,sara ti prego mi servono adesso,3,16523200000,16539200000,16000000,312,0,1
Gabriele Marchilli,mi devi aiutare,3,16552400000,16561600000,9200000,313,0,1
Sara Monaschi,ma io non ho proprio idea di come trovare tutti questi soldi,3,16577200000,16605200000,28000000,314,0,0
Gabriele Marchilli,o magari non sai come trovarli per me eh sara,3,16625600000,16646800000,21200000,315,0,1
Sara Monaschi,per favore,3,16647600000,16657600000,10000000,316,0,0
Gabriele Marchilli,ho capito non c è problema,3,16698000000,16712000000,14000000,317,0,1
Gabriele Marchilli,fai conto che non te li abbia mai chiesti,3,16712800000,16732000000,19200000,318,0,1
Samurai Valerio,parliamo qui dentro che questa l hanno portata oggi,3,17094400000,17123600000,29200000,321,0,1
Samurai Valerio,magari non hanno fatto in tempo a metterci le cimici,3,17128800000,17154000000,25200000,322,0,1
Samurai Valerio,perché a noi non piace finire sulla bocca di tutti,3,17175600000,17197200000,21600000,323,0,1
Samurai Valerio,ma sei sotto pressione la gente sotto pressione cambia,3,17250000000,17284400000,34400000,326,0,1
Samurai Valerio,non fare il coglione giacomi,3,17309200000,17325200000,16000000,327,1,1
Samurai Valerio,io non ti mando l avviso di garanzia,3,17333600000,17351600000,18000000,328,0,1
Amedeo Cinaglia,tieni amore,3,17479200000,17488000000,8800000,329,0,1
Amedeo Cinaglia,sì amore arrivo subito,3,17558800000,17572800000,14000000,332,0,1
Amedeo Cinaglia,vai a tavola,3,17573600000,17584400000,10800000,333,0,1
Amedeo Cinaglia,pare che finucci finirà ai domiciliari,3,17687200000,17706800000,19600000,335,0,1
Amedeo Cinaglia,sì,3,17718000000,17737200000,19200000,337,0,1
Amedeo Cinaglia,è sotto inchiesta,3,17740800000,17753600000,12800000,338,0,1
Amedeo Cinaglia,no,3,17768400000,17786400000,18000000,340,0,1
Amedeo Cinaglia,no,3,17799200000,17807600000,8400000,341,0,1
Amedeo Cinaglia,infatti non c è nessun problema,3,17810000000,17840400000,30400000,343,0,1
Amedeo Cinaglia,iniziate voi,3,17971200000,17981200000,10000000,345,0,1
Gabriele Marchilli,oh,3,18149200000,18158000000,8800000,347,0,1
Gabriele Marchilli,sono io sono gabriele,3,18507200000,18522000000,14800000,353,0,1
Gabriele Marchilli,senti mi serve una mano sto nella merda,3,18526000000,18548000000,22000000,354,1,1
Manfredi Anacleti,lo voglio morto stanotte quel bastardo di aureliano adami,3,18936800000,18970000000,33200000,356,1,1
Manfredi Anacleti,andatelo a prendere nella sua tana,3,18970800000,18987200000,16400000,357,0,1
Alberto Anacleti,vado pure io,3,19240800000,19251200000,10400000,359,0,1
Aureliano Adami,che cos hai che c è,3,19321600000,19339600000,18000000,360,0,1
Aureliano Adami,forza fammi vedere che hai qui,3,19340400000,19374000000,33600000,361,0,1
Aureliano Adami,fammi vedere forza dai,3,19374800000,19396800000,22000000,362,0,1
Aureliano Adami,non mi devi toccare,3,19532400000,19544000000,11600000,368,0,1
Aureliano Adami,mo manco più te ti fai i cazzi tuoi,3,19550800000,19570000000,19200000,369,1,1
Aureliano Adami,non ti potevi sta zitta,3,19570800000,19582800000,12000000,370,0,1
Aureliano Adami,t ho detto che non mi devi toccare,3,19620800000,19635600000,14800000,372,0,1
Aureliano Adami,che cazzo hai fatto,3,19909200000,19921600000,12400000,376,1,1
Livia Adami,è meglio così aurelia,3,19978000000,19992000000,14000000,377,0,0
Livia Adami,era solo un problema,3,20002800000,20014800000,12000000,378,0,0
Livia Adami,è tuo figlio cerca di ricordartelo,3,20085200000,20118000000,32800000,379,0,0
Amedeo Cinaglia,sono molto preoccupato per quello che è successo a finucci,3,20523200000,20548800000,25600000,381,0,1
Samurai Valerio,è solo un altro problema da risolvere,3,20579600000,20596399999,16799999,382,0,1
Samurai Valerio,dobbiamo corrompere chi verrà al suo posto,3,20607600000,20629600000,22000000,383,0,1
Samurai Valerio,e deve essere lei a farlo,3,20630400000,20645600000,15200000,384,0,1
Amedeo Cinaglia,lei forse non ha capito io voglio uscire fuori da tutta questa faccenda,3,20654000000,20686399999,32399999,385,0,1
Amedeo Cinaglia,non voglio che mi succeda mai una cosa del genere,3,20692399999,20713600000,21200001,386,0,1
Amedeo Cinaglia,non mi posso compromettere,3,20714400000,20728000000,13600000,387,0,1
Samurai Valerio,hai fatto qualcosa per me tu sei già compromesso,3,20747199999,20771599999,24400000,388,0,1
Samurai Valerio,hai paura del sindaco dei giornalisti,3,20786000000,20812800000,26800000,389,0,1
Samurai Valerio,non hai capito niente,3,20813600000,20826000000,12400000,390,0,1
Samurai Valerio,non è di loro che devi avere paura,3,20836000000,20856799999,20799999,391,0,1
Samurai Valerio,tra due settimane il sindaco se ne va e questa partita si chiude,3,20902399999,20932800000,30400001,392,0,1
Samurai Valerio,io ho bisogno di qualcuno al posto di finucci ora,3,20940400000,20970400000,30000000,393,0,1
Alberto Anacleti,aspettami qua,3,22574400000,22588800000,14400000,401,0,1
Alberto Anacleti,tu là in fondo corri,3,22665200000,22685600000,20400000,402,0,1
Alberto Anacleti,segui tiziano,3,22742800000,22757200000,14400000,403,0,1
Alberto Anacleti,vai,3,23218800000,23228400000,9600000,404,0,1
Alberto Anacleti,t ho detto vai,3,23402800000,23418400000,15600000,406,0,1
Alberto Anacleti,vattene cazzo,3,23419200000,23433600000,14400000,407,1,1
Alberto Anacleti,vai,3,23443200000,23451600000,8400000,408,0,1
Gabriele Marchilli,che cazzo succede,3,23556400000,23571600000,15200000,409,1,1
Alberto Anacleti,non c è,3,23664000000,23674800000,10800000,411,0,1
Alberto Anacleti,l abbiamo perso,3,23719200000,23733200000,14000000,412,0,1
Gabriele Marchilli,oh,4,579600000,599200000,19600000,4,0,1
Samurai Valerio,rimettiti a dormire è notte,4,961200000,980400000,19200000,7,0,1
Samurai Valerio,adesso vado a casa non ti preoccupare,4,1006400000,1027200000,20800000,9,0,1
Aureliano Adami,oh fai piano che mi brucia,4,1192000000,1203600000,11600000,10,0,1
Gabriele Marchilli,allora,4,1272800000,1281200000,8400000,11,0,1
Gabriele Marchilli,adesso mi dici che ti è successo,4,1290000000,1304799999,14799999,12,0,1
Aureliano Adami,mi vogliono ammazzare,4,1327200000,1344800000,17600000,13,0,1
Gabriele Marchilli,sì,4,1327200000,1344800000,17600000,14,0,1
Gabriele Marchilli,ma perché,4,1345600000,1355600000,10000000,15,0,1
Aureliano Adami,non fare domande gabrie che meno sai e meglio è,4,1369200000,1390800000,21600000,16,0,1
Aureliano Adami,sono vivo per miracolo,4,1402000000,1415200000,13200000,17,0,1
Gabriele Marchilli,no non è un miracolo,4,1422000000,1439600000,17600000,18,0,1
Gabriele Marchilli,devi ringraziare spadino,4,1444000000,1457600000,13600000,19,0,1
Aureliano Adami,ci vai a fare il caffè,4,1485200000,1498800000,13600000,20,0,1
Aureliano Adami,sempre servizi sono no,4,1534800000,1552000000,17200000,22,0,1
Gabriele Marchilli,ti piace eh,4,1683600000,1702800000,19200000,23,0,1
Aureliano Adami,boh,4,1683600000,1702800000,19200000,24,0,1
Aureliano Adami,quando sto con lei mi viene in mente mio padre,4,1716000000,1736800000,20800000,25,0,1
Aureliano Adami,quello è una vita che si scopa le mignotte,4,1754000000,1774400000,20400000,26,1,1
Aureliano Adami,siediti va,4,1787600000,1800400000,12800000,27,0,1
Aureliano Adami,che mi dovevi dire,4,1823200000,1833200000,10000000,28,0,1
Gabriele Marchilli,sto nei casini aurelia,4,1866000000,1878400000,12400000,29,0,1
Gabriele Marchilli,se mi acchiappano a sto giro mi fanno male,4,1883600000,1903200000,19600000,30,0,1
Aureliano Adami,che impiccio hai fatto,4,1905200000,1915600000,10400000,31,0,1
Gabriele Marchilli,devo ridare 30 000 a uno,4,1920400000,1933200000,12800000,32,0,1
Aureliano Adami,a uno a cui tocca darglieli,4,1954000000,1968400000,14400000,33,0,1
Gabriele Marchilli,non so dove cazzo trovarli,4,2004800000,2021600000,16800000,34,1,1
Aureliano Adami,quando glieli devi dare,4,2078800000,2090400000,11600000,35,0,1
Gabriele Marchilli,lascia perdere,4,2096800000,2109600000,12800000,36,0,1
Gabriele Marchilli,perché che c hai in mente,4,2133200000,2148000000,14800000,37,0,1
Aureliano Adami,va tranquillo che in gabbia per i cazzi tuoi non ci finisco,4,2158800000,2183200000,24400000,38,1,1
Aureliano Adami,però te mi hai aiutato stanotte,4,2225600000,2243200000,17600000,39,0,1
Aureliano Adami,te li trovo io sti soldi,4,2254400000,2265600000,11200000,40,0,1
Gabriele Marchilli,grazie aurelia,4,2286000000,2294800000,8800000,41,0,1
Aureliano Adami,ah un altra cosa,4,2335200000,2347200000,12000000,42,0,1
Aureliano Adami,fammi parlare con spadino di persona,4,2362800000,2377200000,14400000,43,0,1
Gabriele Marchilli,ci penso io,4,2386000000,2396800000,10800000,44,0,1
Manfredi Anacleti,questo succede quando nasci zingaro,4,2819200000,2841200000,22000000,49,0,1
Manfredi Anacleti,poi le bestie siamo noi,4,2851200000,2869200000,18000000,50,0,1
Manfredi Anacleti,sta storia non può restare impunita,4,2884800000,2906000000,21200000,51,0,1
Manfredi Anacleti,facciamoli sposare e poi facciamo capire a questa città,4,2916800000,2946000000,29200000,52,0,1
Manfredi Anacleti,che l aria è cambiata,4,2946800000,2963200000,16400000,53,0,1
Manfredi Anacleti,e che ci devono rispettare,4,2972400000,2987200000,14800000,54,0,1
Manfredi Anacleti,certo ti capisco,4,3263200000,3277600000,14400000,64,0,1
Manfredi Anacleti,ma ti assicuro che tua figlia si sbaglia,4,3300800000,3320400000,19600000,65,0,1
Manfredi Anacleti,dai spadi alzati,4,3498400000,3514000000,15600000,66,0,1
Alberto Anacleti,ma che vuoi ancora,4,3532400000,3540800000,8400000,67,0,1
Manfredi Anacleti,che la pianti di fare cazzate,4,3544000000,3560400000,16400000,68,1,1
Manfredi Anacleti,non sei neanche capace di prendere moglie,4,3578000000,3599200000,21200000,69,0,1
Alberto Anacleti,ma di che stai a parlare,4,3600000000,3621200000,21200000,70,0,1
Manfredi Anacleti,di angelica,4,3600000000,3621200000,21200000,71,0,1
Manfredi Anacleti,non ti vuole più sposare,4,3633600000,3648800000,15200000,72,0,1
Alberto Anacleti,pazienza vorrà dire che me ne troverete un altra no,4,3649600000,3678400000,28800000,73,0,1
Manfredi Anacleti,mmh,4,3679200000,3687600000,8400000,74,0,1
Manfredi Anacleti,lo dico un altra volta e non lo ripeto più,4,3688400000,3710000000,21600000,75,0,1
Manfredi Anacleti,tu ti devi sposare a questa cazzo di angelica,4,3710800000,3729200000,18400000,76,1,1
Manfredi Anacleti,eh,4,3736800000,3745200000,8400000,77,0,1
Manfredi Anacleti,i sale sono molto importanti,4,3749600000,3768400000,18800000,78,0,1
Manfredi Anacleti,abbiamo grandi progetti,4,3776400000,3793200000,16800000,79,0,1
Manfredi Anacleti,andiamo,4,3815600000,3824000000,8400000,80,0,1
Manfredi Anacleti,dai andiamo buffone alzati forza,4,3838800000,3864400000,25600000,81,0,1
Samurai Valerio,è vecchio,4,4023600000,4034800000,11200000,84,0,1
Samurai Valerio,questo è stato un campione merita un po di rispetto,4,4092800000,4120000000,27200000,86,0,1
Samurai Valerio,però se questi miliardi possono ballare nella capitale,4,4186800000,4214400000,27600000,89,0,1
Samurai Valerio,è solo grazie a me,4,4215200000,4225200000,10000000,90,0,1
Samurai Valerio,lasciami lavorare già te l ho detto roma ha i suoi tempi,4,4242000000,4273200000,31200000,91,0,1
Aureliano Adami,ciao bello,4,4727600000,4750400000,22800000,97,0,1
Aureliano Adami,bene fratello,4,4763200000,4781600000,18400000,99,0,1
Aureliano Adami,ciao ragazzi,4,4792400000,4800800000,8400000,100,0,1
Aureliano Adami,oh,4,4803200000,4811600000,8400000,101,0,1
Livia Adami,come stai che ti sei fatto,4,4831200000,4854400000,23200000,102,0,0
Aureliano Adami,non è niente è un graffio,4,4831200000,4854400000,23200000,103,0,1
Livia Adami,siamo stati in pensiero tutta la notte,4,4876800000,4894800000,18000000,105,0,0
Aureliano Adami,un amico mio mi ha portato da una parte,4,4895600000,4915200000,19600000,106,0,1
Aureliano Adami,c era bisogno che mi sparavano per farti preoccupare,4,5020000000,5043600000,23600000,110,0,1
Gabriele Marchilli,è lui,4,5270400000,5278800000,8400000,115,0,1
Alberto Anacleti,tizia fallo passare,4,5306800000,5317200000,10400000,116,0,1
Alberto Anacleti,che cazzo sei venuto a fare,4,5373600000,5395200000,21600000,117,1,1
Gabriele Marchilli,ti devo parlare,4,5373600000,5395200000,21600000,118,0,1
Alberto Anacleti,mo non ti posso dare retta ci sentiamo dopo,4,5396000000,5415600000,19600000,119,0,1
Gabriele Marchilli,non è per me è per aureliano,4,5416400000,5434400000,18000000,120,0,1
Gabriele Marchilli,ti vuole vedere,4,5439200000,5447600000,8400000,121,0,1
Alberto Anacleti,perché,4,5462400000,5473200000,10800000,122,0,1
Gabriele Marchilli,perché gli hai salvato la vita forse è per questo,4,5482400000,5504000000,21600000,123,0,1
Alberto Anacleti,digli che lo chiamo più tardi,4,5518400000,5532800000,14400000,124,0,1
Alberto Anacleti,oh,4,5553200000,5561600000,8400000,125,0,1
Alberto Anacleti,sta bene,4,5583600000,5593600000,10000000,126,0,1
Gabriele Marchilli,sì,4,5604000000,5612400000,8400000,127,0,1
Livia Adami,ma che stai a fare,4,5921200000,5933600000,12400000,128,0,0
Aureliano Adami,niente,4,5945200000,5953600000,8400000,129,0,1
Livia Adami,aurelia,4,5959600000,5968400000,8800000,130,0,0
Aureliano Adami,eh,4,5974800000,5983200000,8400000,131,0,1
Livia Adami,quanto ti serve,4,5989600000,6009200000,19600000,132,0,0
Aureliano Adami,poco,4,5989600000,6009200000,19600000,133,0,1
Livia Adami,e li vuoi fregare a papà,4,6032400000,6043600000,11200000,134,0,0
Aureliano Adami,sono per un amico mio,4,6052800000,6065600000,12800000,135,0,1
Livia Adami,e da quando aiuti gli amici,4,6066400000,6079200000,12800000,136,0,0
Aureliano Adami,da quando mi salvano la vita,4,6097600000,6112400000,14800000,137,0,1
Livia Adami,sono per sdebitarti,4,6128800000,6141600000,12800000,138,0,0
Livia Adami,la vuoi fare finita,4,6153200000,6165600000,12400000,139,0,0
Livia Adami,è da quando siamo ragazzini che ti paro il culo ma mo basta mo devi crescere,4,6166400000,6200400000,34000000,140,1,0
Aureliano Adami,non mi fare la predica non è il caso,4,6201200000,6220000000,18800000,141,0,1
Livia Adami,fai una stronzata dopo l altra e io ogni volta devo rimediare,4,6220800000,6248400000,27600000,142,1,0
Aureliano Adami,m hai ammazzato il cane li,4,6256400000,6271200000,14800000,143,0,1
Aureliano Adami,che rimedi,4,6276000000,6285600000,9600000,144,0,1
Livia Adami,la colpa è solo tua se l avevi lasciato andare quello era ancora vivo,4,6290400000,6325600000,35200000,145,0,0
Aureliano Adami,e se tu ti eri fatta i cazzi tuoi non m aveva sparato nessuno pensa,4,6353200000,6387600000,34400000,146,1,1
Angelica Sale,che vuoi,4,7014400000,7022800000,8400000,147,0,0
Alberto Anacleti,ti piace,4,7038800000,7047600000,8800000,148,0,1
Angelica Sale,spadi dimmi che vuoi che c ho da fare,4,7052400000,7068000000,15600000,149,0,0
Alberto Anacleti,dai ti porto a fare un giro,4,7084800000,7105600000,20800000,150,0,1
Angelica Sale,non mi va,4,7084800000,7105600000,20800000,151,0,0
Alberto Anacleti,ti porto a mangiare in un posto bello,4,7128400000,7145600000,17200000,152,0,1
Angelica Sale,ho detto che non mi va,4,7146400000,7159600000,13200000,153,0,0
Alberto Anacleti,che ti va di fare,4,7177600000,7187200000,9600000,154,0,1
Angelica Sale,con te niente,4,7188000000,7201200000,13200000,155,0,0
Alberto Anacleti,dai un ora e ti riporto a casa,4,7247200000,7262800000,15600000,156,0,1
Alberto Anacleti,eh,4,7271600000,7280000000,8400000,157,0,1
Angelica Sale,prego,4,7374800000,7383200000,8400000,158,0,0
Amedeo Cinaglia,vado di fretta,4,7519600000,7530000000,10400000,160,0,1
Amedeo Cinaglia,poi se ci sediamo al tavolino a fare colazione chissà che pensa tuo marito,4,7544000000,7576000000,32000000,161,0,1
Amedeo Cinaglia,da credere che abbiamo una storia,4,7594000000,7622000000,28000000,163,0,1
Amedeo Cinaglia,volevo sapere che si diceva al partito,4,7622800000,7638800000,16000000,165,0,1
Amedeo Cinaglia,chi mettono al posto di finucci,4,7653600000,7668400000,14800000,166,0,1
Amedeo Cinaglia,quindi,4,7723200000,7731600000,8400000,168,0,1
Amedeo Cinaglia,chi cazzo mettono,4,7754000000,7765600000,11600000,170,1,1
Amedeo Cinaglia,chi l architetto,4,7801200000,7820000000,18800000,172,0,1
Amedeo Cinaglia,che bazzicava il partito e nessuno gli dava retta,4,7825600000,7845600000,20000000,174,0,1
Amedeo Cinaglia,un altro che non ha mai fatto carriera,4,7891600000,7910400000,18800000,176,0,1
Amedeo Cinaglia,beh visto la merda in cui sguazzate non volevo un altro finucci a fianco,4,7963200000,8006000000,42800000,178,1,1
Amedeo Cinaglia,questa volta voglio farmi trovare pronto,4,8030800000,8048800000,18000000,179,0,1
Amedeo Cinaglia,è una minaccia o un consiglio,4,8084800000,8111200000,26400000,181,0,1
Amedeo Cinaglia,grazie per l informazione,4,8122400000,8136000000,13600000,183,0,1
Aureliano Adami,oh,4,8268000000,8276400000,8400000,184,0,1
Aureliano Adami,grazie romole,4,8280000000,8291200000,11200000,185,0,1
Gabriele Marchilli,la ferita come va,4,8326400000,8344400000,18000000,186,0,1
Aureliano Adami,meglio,4,8326400000,8344400000,18000000,187,0,1
Gabriele Marchilli,ho parlato con spadino mo sta impicciato ti chiama lui,4,8354000000,8384800000,30800000,188,0,1
Aureliano Adami,va bene,4,8390000000,8399600000,9600000,189,0,1
Aureliano Adami,senti invece per quella cosa dei soldi,4,8409200000,8428400000,19200000,190,0,1
Aureliano Adami,sì ti volevo presentare,4,8471600000,8498000000,26400000,192,0,1
Aureliano Adami,andiamo su che qua devono parlare di affari,4,8536800000,8570000000,33200000,194,0,1
Aureliano Adami,hai visto sì,4,8734400000,8746000000,11600000,195,0,1
Aureliano Adami,quello era quel pezzo di merda di samurai,4,8746800000,8767200000,20400000,196,1,1
Gabriele Marchilli,ah,4,8772800000,8783200000,10400000,197,0,1
Aureliano Adami,chiudi la porta,4,8772800000,8783200000,10400000,198,0,1
Aureliano Adami,mortacci sua se non era per lui stavamo festeggiando adesso,4,8803600000,8830000000,26400000,199,0,1
Gabriele Marchilli,non mi ci far pensare,4,8850400000,8860800000,10400000,200,0,1
Aureliano Adami,per questa cosa dei soldi adesso è complicato,4,8887600000,8908800000,21200000,201,0,1
Aureliano Adami,però l idea ce l ho,4,8912800000,8924800000,12000000,202,0,1
Gabriele Marchilli,quale,4,8936000000,8944400000,8400000,203,0,1
Aureliano Adami,andiamo dal prete,4,8953200000,8961600000,8400000,204,0,1
Aureliano Adami,gli togliamo tutto,4,8979200000,8990400000,11200000,205,0,1
Gabriele Marchilli,aurelia per favore,4,8994800000,9022800000,28000000,206,0,1
Aureliano Adami,quanto sei impicciato per sto buffo,4,8994800000,9022800000,28000000,207,0,1
Gabriele Marchilli,tanto,4,9043600000,9054000000,10400000,208,0,1
Aureliano Adami,ecco,4,9043600000,9054000000,10400000,209,0,1
Aureliano Adami,allora fidati e fammi lavorare,4,9060000000,9075200000,15200000,210,0,1
Gabriele Marchilli,ti faccio lavorare,4,9090800000,9100800000,10000000,211,0,1
Samurai Valerio,avrai la tua vendetta ma non adesso,4,9152800000,9173200000,20400000,213,0,1
Samurai Valerio,adesso devi stare buono,4,9174000000,9187200000,13200000,214,0,1
Samurai Valerio,è la tua ultima parola,4,9411600000,9425200000,13600000,219,0,1
Samurai Valerio,non li ho fatti apposta,4,9532000000,9544000000,12000000,222,0,1
Samurai Valerio,ci siamo sbagliati,4,9702000000,9714800000,12800000,223,0,1
Samurai Valerio,il problema non è il figlio è il padre,4,9730400000,9755200000,24800000,224,0,1
Samurai Valerio,non posso rischiare di perdere gli affari per colpa di tullio adami,4,9776800000,9803600000,26800000,226,0,1
Samurai Valerio,la soluzione l ho vista dentro casa loro,4,9893600000,9914400000,20800000,228,0,1
Alberto Anacleti,vieni qua,4,9983600000,9996800000,13200000,232,0,1
Alberto Anacleti,ciao,4,9997600000,10016000000,18400000,234,0,1
Alberto Anacleti,no,4,10032400000,10041600000,9200000,236,0,1
Alberto Anacleti,che dici è tutto vuoto,4,10047200000,10078800000,31600000,238,0,1
Alberto Anacleti,va bene qua grazie,4,10118400000,10138000000,19600000,240,0,1
Alberto Anacleti,scegli quello che ti pare tanto oggi mangiamo tutto,4,10159600000,10186800000,27200000,241,0,1
Angelica Sale,ma che ci siamo venuti a fare,4,10222000000,10236800000,14800000,242,0,0
Alberto Anacleti,hai detto a tuo padre che non ti caco e mo gli dici che ti porto a pranzo fuori,4,10243599999,10278399999,34800000,243,0,1
Angelica Sale,senti io non sono stupida spadi,4,10279200000,10298000000,18800000,244,0,0
Angelica Sale,potevi evitare tutta sta sceneggiata e dirmi subito che non mi vuoi sposare,4,10300400000,10339200000,38800000,245,0,0
Alberto Anacleti,no io sto qua per te,4,10351199999,10374400000,23200001,246,0,1
Angelica Sale,sì ma ormai è tardi,4,10375200000,10387600000,12400000,247,0,0
Alberto Anacleti,tardi per mangiare sì perché ho fame,4,10388399999,10405200000,16800001,248,0,1
Alberto Anacleti,oh amico,4,10405999999,10415600000,9600001,249,0,1
Alberto Anacleti,ciao bello come stai tutto a posto questi li prendo io grazie,4,10443199999,10477200000,34000001,250,0,1
Alberto Anacleti,oh,4,10502800000,10515600000,12800000,251,0,1
Alberto Anacleti,ah,4,10537200000,10550000000,12800000,252,0,1
Alberto Anacleti,salve buon appetito,4,10590000000,10610000000,20000000,253,0,1
Alberto Anacleti,non ho capito scusa che dobbiamo fare,4,10709200000,10731600000,22400000,254,0,1
Alberto Anacleti,ecco bravo,4,10796800000,10812000000,15200000,257,0,1
Alberto Anacleti,alla nostra,4,10869600000,10878000000,8400000,259,0,1
Alberto Anacleti,sai che ti dico,4,11004400000,11015600000,11200000,264,0,1
Alberto Anacleti,a me sto posto non mi piace più così tanto,4,11016400000,11038800000,22400000,265,0,1
Alberto Anacleti,vieni andiamo ti porto da un altra parte,4,11039600000,11061200000,21600000,266,0,1
Alberto Anacleti,salve a tutti buon appetito,4,11133600000,11148000000,14400000,267,0,1
Alberto Anacleti,la signorina gradisce della frutta,4,11404400000,11424400000,20000000,268,0,1
Alberto Anacleti,andiamo,4,11447200000,11456800000,9600000,269,0,1
Aureliano Adami,che fai suoni,4,11560400000,11571600000,11200000,270,0,1
Gabriele Marchilli,per vedere se sta in casa,4,11581600000,11608000000,26400000,271,0,1
Aureliano Adami,se risponde che gli dici cammina,4,11581600000,11608000000,26400000,272,0,1
Aureliano Adami,aspetta,4,11672000000,11680400000,8400000,273,0,1
Aureliano Adami,vacci a parlare,4,11747200000,11756400000,9200000,274,0,1
Gabriele Marchilli,che gli dico,4,11760800000,11774400000,13600000,275,0,1
Aureliano Adami,che cazzo ne so,4,11760800000,11774400000,13600000,276,1,1
Aureliano Adami,inventati qualcosa tu parli e io entro,4,11775200000,11792400000,17200000,277,0,1
Gabriele Marchilli,salve,4,11826400000,11834800000,8400000,278,0,1
Gabriele Marchilli,buongiorno,4,11842400000,11855200000,12800000,280,0,1
Gabriele Marchilli,lei è il portiere dello stabile,4,11856000000,11872400000,16400000,281,0,1
Gabriele Marchilli,salve sono uno studente di legge,4,11873200000,11891600000,18400000,283,0,1
Gabriele Marchilli,sto preparando la tesi di laurea sulle condizioni dei portieri di roma,4,11896400000,11924800000,28400000,284,0,1
Gabriele Marchilli,in particolare in riferimento con i regolamenti condominiali,4,11925600000,11959200000,33600000,285,0,1
Gabriele Marchilli,la posso disturbare,4,11960000000,11978000000,18000000,286,0,1
Aureliano Adami,dai,4,12120000000,12129200000,9200000,289,0,1
Aureliano Adami,vedi il prete mortacci sua,4,12694800000,12714000000,19200000,290,0,1
Gabriele Marchilli,stasera le ridò tutto,4,13299200000,13312400000,13200000,291,0,1
Gabriele Marchilli,glielo garantisco,4,13316000000,13328400000,12400000,292,0,1
Samurai Valerio,non ti preoccupare i soldi non sono più un problema,4,13334800000,13359200000,24400000,293,0,1
Samurai Valerio,guarda questo cavallo,4,13369600000,13381200000,11600000,294,0,1
Samurai Valerio,a nessuno piace farsi domare,4,13406400000,13430000000,23600000,295,0,1
Samurai Valerio,ma alla fine sai che c è,4,13434800000,13452400000,17600000,296,0,1
Samurai Valerio,si campa meglio da sudditi,4,13454800000,13470400000,15600000,297,0,1
Samurai Valerio,hai da mangiare non hai pensieri,4,13480000000,13501600000,21600000,298,0,1
Samurai Valerio,basta che fai quello che ti dicono,4,13508000000,13524400000,16400000,299,0,1
Samurai Valerio,i cavalli che sono animali intelligenti questo l hanno capito,4,13542000000,13568400000,26400000,300,0,1
Samurai Valerio,tu che vuoi fare,4,13601600000,13613600000,12000000,301,0,1
Gabriele Marchilli,le ridò tutto gliel ho detto,4,13649200000,13678400000,29200000,302,0,1
Samurai Valerio,sei figlio di una guardia,4,13649200000,13678400000,29200000,303,0,1
Samurai Valerio,hai spinto pasticche nella palestra mia,4,13684000000,13704000000,20000000,304,0,1
Samurai Valerio,non hai molta scelta gabrie,4,13712800000,13729200000,16400000,305,0,1
Samurai Valerio,o fai quello che ti dico o tuo padre muore,4,13739600000,13764800000,25200000,306,0,1
Gabriele Marchilli,che dovrei fare,4,13854800000,13864000000,9200000,307,0,1
Samurai Valerio,devi ammazzare un adami,4,13872400000,13884800000,12400000,308,0,1
Samurai Valerio,tullio,4,13895600000,13905200000,9600000,309,0,1
Samurai Valerio,il padre dell amico tuo,4,13926000000,13939600000,13600000,310,0,1
Aureliano Adami,quiri levati dal cazzo non è ora di fare i conti,4,14381200000,14401600000,20400000,317,1,1
Aureliano Adami,mo ho capito perché il chiosco di mamma non lo posso toccare,4,14582000000,14608800000,26800000,319,0,1
Aureliano Adami,perché con quel terreno ci dovete fare impicci col padrone tuo che state a fare,4,14653600000,14685200000,31600000,320,0,1
Aureliano Adami,la finisci di inchinarti davanti a quel pezzo di merda,4,14723200000,14747200000,24000000,322,1,1
Aureliano Adami,del samurai,4,14748000000,14770800000,22800000,324,0,1
Aureliano Adami,e sto a parlare di te che sei lo schiavo suo che schifo,4,14771600000,14794400000,22800000,325,0,1
Livia Adami,prima t ha difeso di fronte a lui,4,14795200000,14819200000,24000000,326,0,0
Aureliano Adami,statti zitta,4,14795200000,14819200000,24000000,327,0,1
Aureliano Adami,fatti i cazzi tuoi e finiscila di difendere sto coglione,4,14820000000,14847600000,27600000,328,1,1
Aureliano Adami,ma che cazzo stai a dire,4,14906000000,14922000000,16000000,331,1,1
Aureliano Adami,perché,4,14922800000,14934000000,11200000,332,0,1
Aureliano Adami,che cazzo ho fatto per non meritarmi niente dimmi,4,14940000000,14968400000,28400000,333,1,1
Aureliano Adami,da quando son nato non mi puoi vedere,4,14969200000,14985200000,16000000,334,0,1
Aureliano Adami,perché pensi che mamma è morta per colpa mia,4,14986000000,15005200000,19200000,335,0,1
Aureliano Adami,dimmelo,4,15021200000,15032000000,10800000,336,0,1
Aureliano Adami,dai,4,15032800000,15041200000,8400000,337,0,1
Aureliano Adami,vaffanculo,4,15068800000,15080400000,11600000,338,1,1
Amedeo Cinaglia,sì,4,15350800000,15359200000,8400000,339,0,1
Amedeo Cinaglia,dott taccon,4,15385200000,15399600000,14400000,340,0,1
Amedeo Cinaglia,buongiorno cinaglia,4,15400400000,15415600000,15200000,342,0,1
Amedeo Cinaglia,prego si accomodi,4,15421600000,15440400000,18800000,343,0,1
Amedeo Cinaglia,non si ricorda di me,4,15452400000,15464000000,11600000,345,0,1
Amedeo Cinaglia,io invece mi ricordo molto bene di lei,4,15474400000,15493200000,18800000,346,0,1
Amedeo Cinaglia,nel 99 al partito il giorno in cui fece quel bellissimo discorso,4,15494000000,15528400000,34400000,347,0,1
Amedeo Cinaglia,e lanciò l idea sugli stadi generali della cultura,4,15529200000,15552400000,23200000,348,0,1
Amedeo Cinaglia,bene,4,15580800000,15603200000,22400000,351,0,1
Amedeo Cinaglia,d ora in poi lavoreremo insieme,4,15604000000,15621200000,17200000,352,0,1
Amedeo Cinaglia,lo so,4,15642400000,15668000000,25600000,355,0,1
Amedeo Cinaglia,mi sono fidato quando ti fidi non ti metti a controllare,4,15737600000,15763600000,26000000,358,0,1
Amedeo Cinaglia,c era davvero bisogno di una persona come lei qui,4,15868800000,15892400000,23600000,363,0,1
Amedeo Cinaglia,grazie,4,15922400000,15931200000,8800000,365,0,1
Gabriele Marchilli,ciao mara,4,16520800000,16531600000,10800000,367,0,1
Gabriele Marchilli,sì,4,16540000000,16556000000,16000000,369,0,1
Gabriele Marchilli,grazie,4,16580400000,16589200000,8800000,371,0,1
Gabriele Marchilli,magari ripasso,4,16928400000,16950000000,21600000,375,0,1
Gabriele Marchilli,sì mi sta bene,4,17013600000,17025200000,11600000,379,0,1
Gabriele Marchilli,mi sento stanco papà,4,17108000000,17135600000,27600000,382,0,1
Gabriele Marchilli,sì mi piacerebbe,4,17275600000,17299600000,24000000,390,0,1
Contessa Sveva Della Rocca Croce,in commissione il presidente cinaglia non è corrotto,4,17616800000,17645200000,28400000,393,0,0
Contessa Sveva Della Rocca Croce,ma devi avvicinare taccon prima che lo faccia samurai,4,17646000000,17676400000,30400000,394,0,0
Contessa Sveva Della Rocca Croce,devi fargli capire che solo lui può cambiare le cose,4,17686000000,17715600000,29600000,395,0,0
Contessa Sveva Della Rocca Croce,devi coccolarlo,4,17720400000,17732400000,12000000,396,0,0
Contessa Sveva Della Rocca Croce,farlo sentire speciale,4,17737200000,17750000000,12800000,397,0,0
Sara Monaschi,lei mi dà tutti questi consigli,4,17792800000,17817600000,24800000,398,0,0
Contessa Sveva Della Rocca Croce,danno fastidio,4,17818400000,17831200000,12800000,399,0,0
Contessa Sveva Della Rocca Croce,se vuoi fare di testa tua,4,17836800000,17874000000,37200000,400,0,0
Sara Monaschi,no assolutamente anzi,4,17836800000,17874000000,37200000,401,0,0
Sara Monaschi,è solo che mi imbarazzano un po perché prima o poi dovrò pensare a sdebitarmi,4,17881600000,17921200000,39600000,402,0,0
Contessa Sveva Della Rocca Croce,non ti preoccupare,4,17922000000,17937200000,15200000,403,0,0
Contessa Sveva Della Rocca Croce,troveremo il modo,4,17941200000,17956400000,15200000,404,0,0
Sara Monaschi,certo,4,17962400000,17972000000,9600000,405,0,0
Sara Monaschi,adesso devo andare,4,17984400000,17998000000,13600000,406,0,0
Sara Monaschi,ho un impegno,4,18008400000,18019200000,10800000,407,0,0
Contessa Sveva Della Rocca Croce,a presto cara,4,18048800000,18058800000,10000000,408,0,0
Sara Monaschi,arrivederci,4,18066000000,18074800000,8800000,409,0,0
Sara Monaschi,non si disturbi vado sola,4,18077600000,18095200000,17600000,410,0,0
Sara Monaschi,mi aspettano in vaticano,4,18241600000,18255600000,14000000,411,0,0
Contessa Sveva Della Rocca Croce,non voglio sapere dove vai sara non sono affari miei,4,18261200000,18289200000,28000000,412,0,0
Sara Monaschi,faccio tardi arrivederci,4,18305600000,18317600000,12000000,413,0,0
Aureliano Adami,se doveva cascare da mo che era cascato,4,18417200000,18440400000,23200000,415,0,1
Aureliano Adami,vorrei che questo posto diventasse il più bello di ostia,4,18557600000,18586800000,29200000,418,0,1
Aureliano Adami,anzi di roma,4,18598000000,18608800000,10800000,419,0,1
Aureliano Adami,vorrei che la gente ci venisse da fuori capito,4,18625600000,18648400000,22800000,420,0,1
Aureliano Adami,lascia stare,4,18726000000,18736000000,10000000,423,0,1
Aureliano Adami,a te che piace invece,4,18750400000,18767200000,16800000,424,0,1
Aureliano Adami,ma che stai a dire,4,18884000000,18895600000,11600000,426,0,1
Aureliano Adami,a fare che la gente da là se ne va,4,18911600000,18931200000,19600000,427,0,1
Aureliano Adami,ho capito ma perché laggiù,4,18962400000,18980000000,17600000,429,0,1
Sara Monaschi,ehi ciao,4,19242400000,19260800000,18400000,431,0,0
Gabriele Marchilli,ehi,4,19242400000,19260800000,18400000,432,0,1
Sara Monaschi,senti ho ripensato a ieri,4,19275200000,19291600000,16400000,433,0,0
Sara Monaschi,a quei soldi che mi hai chiesto e,4,19292400000,19309200000,16800000,434,0,0
Sara Monaschi,ti posso dare una parte ok,4,19314000000,19333600000,19600000,435,0,0
Sara Monaschi,non molto però magari,4,19334400000,19369200000,34800000,436,0,0
Gabriele Marchilli,perché ora mi dai i soldi,4,19334400000,19369200000,34800000,437,0,1
Gabriele Marchilli,cos è cambiato,4,19375200000,19385200000,10000000,438,0,1
Sara Monaschi,niente,4,19400000000,19408400000,8400000,439,0,0
Sara Monaschi,è che ti ho pensato e ti voglio aiutare,4,19418800000,19445200000,26400000,440,0,0
Gabriele Marchilli,non mi servono più ho risolto,4,19446000000,19467200000,21200000,441,0,1
Sara Monaschi,hai risolto,4,19479200000,19489600000,10400000,442,0,0
Sara Monaschi,e allora perché hai questa faccia,4,19494400000,19510800000,16400000,443,0,0
Sara Monaschi,mi dici che succede,4,19528400000,19543200000,14800000,444,0,0
Gabriele Marchilli,tu non mi puoi aiutare sara,4,19569200000,19582800000,13600000,445,0,1
Sara Monaschi,ma,4,19603200000,19622000000,18800000,446,0,0
Gabriele Marchilli,ciao sara,4,19603200000,19622000000,18800000,447,0,1
Alberto Anacleti,tie,4,19682000000,19690800000,8800000,448,0,1
Angelica Sale,e dammi,4,19702000000,19729200000,27200000,449,0,0
Alberto Anacleti,no non ti do niente,4,19702000000,19729200000,27200000,450,0,1
Alberto Anacleti,tiè,4,19734400000,19742800000,8400000,451,0,1
Alberto Anacleti,vedi ti tratto sempre male però almeno ti faccio ridere,4,19772800000,19798800000,26000000,452,0,1
Alberto Anacleti,l erba che ho io a roma non ce l ha nessuno,4,19811200000,19830000000,18800000,453,0,1
Angelica Sale,un valido motivo per sposarsi direi,4,19839200000,19862800000,23600000,454,0,0
Alberto Anacleti,fondamentale,4,19902000000,19914000000,12000000,455,0,1
Angelica Sale,ce ne sono anche altri,4,19945600000,19959600000,14000000,456,0,0
Alberto Anacleti,io e te non ci dovremmo nemmeno sfiorare prima del matrimonio,4,20085600000,20115200000,29600000,457,0,1
Angelica Sale,mo ti importa delle regole,4,20154000000,20171600000,17600000,458,0,0
Alberto Anacleti,no mica per niente,4,20185600000,20198000000,12400000,459,0,1
Alberto Anacleti,è che se mi becca tuo padre m ammazza,4,20218400000,20237600000,19200000,460,0,1
Angelica Sale,basta non farglielo sapere,4,20249600000,20267200000,17600000,461,0,0
Aureliano Adami,dimmi dove cazzo sei finito,4,20566399999,20585200000,18800001,462,1,1
Gabriele Marchilli,aurelia,4,20566399999,20585200000,18800001,463,0,1
Gabriele Marchilli,mi spiace ma mi è successo,4,20586000000,20597600000,11600000,464,0,1
Aureliano Adami,qualunque cosa succede tu fai il palo e aspetti il compagno tuo hai capito,4,20598400000,20633200000,34800000,465,0,1
Gabriele Marchilli,sì lo so,4,20635600000,20648400000,12800000,466,0,1
Aureliano Adami,sta zitto,4,20635600000,20648400000,12800000,467,0,1
Aureliano Adami,non ti spacco la capoccia e ancora stai in piedi perché è andata liscia,4,20667199999,20697199999,30000000,468,0,1
Aureliano Adami,e perché ti dovevo un favore,4,20705600000,20718800000,13200000,469,0,1
Aureliano Adami,mo stiamo pari,4,20735200000,20746799999,11599999,470,0,1
Aureliano Adami,va bene,4,20765600000,20774000000,8400000,471,0,1
Gabriele Marchilli,va bene,4,20776799999,20785200000,8400001,472,0,1
Aureliano Adami,tie guarda il prete che robetta,4,20868000000,20890000000,22000000,473,0,1
Aureliano Adami,solo con questo ci farai venti sacchi,4,20930000000,20947600000,17600000,474,0,1
Aureliano Adami,prendi pure questo e col buffo stai a posto,4,20998800000,21025200000,26400000,475,0,1
Gabriele Marchilli,grazie aurelia,4,21027200000,21038800000,11600000,476,0,1
Aureliano Adami,te lo volevo presentare stamattina ma avevi da fare,4,21112400000,21133200000,20800000,480,0,1
Aureliano Adami,è gabriele quello che mi ha salvato,4,21146800000,21172400000,25600000,481,0,1
Aureliano Adami,va bene,4,21271200000,21288000000,16800000,487,0,1
Aureliano Adami,meno male per stasera ce lo siamo levato dal cazzo,4,21322800000,21354400000,31600000,488,1,1
Gabriele Marchilli,perché,4,21368000000,21376400000,8400000,489,0,1
Aureliano Adami,questo è il giorno fisso della scopata con la puttana e non glielo leva nessuno,4,21377200000,21414000000,36800000,490,1,1
Aureliano Adami,mo hai capito perché con isabel mi prende male,4,21449600000,21471200000,21600000,491,0,1
Aureliano Adami,perché non voglio diventare come lui,4,21482800001,21497200000,14399999,492,0,1
Aureliano Adami,oh vattene va a fare quello che devi fare,4,21544400000,21568400000,24000000,493,0,1
Aureliano Adami,io mi butto a letto,4,21569200000,21583600000,14400000,494,0,1
Gabriele Marchilli,sì,4,21569200000,21583600000,14400000,495,0,1
Gabriele Marchilli,ciao aurelia,4,21607200000,21616000000,8800000,496,0,1
Livia Adami,tu sei gabriele vero,4,21733600000,21747600000,14000000,500,0,0
Gabriele Marchilli,sì,4,21770400000,21778800000,8400000,501,0,1
Livia Adami,ti volevo ringraziare,4,21786800000,21800000000,13200000,502,0,0
Livia Adami,mio fratello è la persona a cui tengo di più al mondo,4,21816800000,21841200000,24400000,503,0,0
Gabriele Marchilli,figurati ho fatto quello che avrebbe fatto qualsiasi amico,4,21847600000,21875600000,28000000,504,0,1
Livia Adami,ma lui di amici ne ha pochi,4,21876400000,21896400000,20000000,505,0,0
Livia Adami,da quanto tempo vi conoscete,4,21897200000,21919200000,22000000,506,0,0
Gabriele Marchilli,non da molto,4,21928800000,21942000000,13200000,507,0,1
Gabriele Marchilli,però ci siamo capiti subito,4,21942800000,21961200000,18400000,508,0,1
Livia Adami,è strano che si capisce con uno come te,4,21962000000,21982000000,20000000,509,0,0
Livia Adami,con il figlio di una guardia,4,21987600000,22000000000,12400000,510,0,0
Gabriele Marchilli,non lo so magari gli sto simpatico,4,22034400000,22059200000,24800000,511,0,1
Livia Adami,ciao gabrie è stato un piacere,4,22072400000,22092800000,20400000,512,0,0
Livia Adami,attento,4,22102800000,22112000000,9200000,514,0,0
Gabriele Marchilli,sono gabriele,4,22497600000,22506000000,8400000,515,0,1
Gabriele Marchilli,senti tullio adami è uscito di casa adesso ma,4,22536400000,22561600000,25200000,516,0,1
Gabriele Marchilli,ma l ho perso,4,22568800000,22582000000,13200000,517,0,1
Samurai Valerio,fammi sapere che succede,4,22690800000,22706000000,15200000,521,0,1
Manfredi Anacleti,spadi,4,22889200000,22900800000,11600000,523,0,1
Manfredi Anacleti,com è andata con angelica,4,22906000000,22924000000,18000000,524,0,1
Alberto Anacleti,una favola ci sposiamo tranquillo,4,22931200000,22949600000,18400000,525,0,1
Manfredi Anacleti,vorrei vedere,4,22950400000,22960400000,10000000,526,0,1
Amedeo Cinaglia,le devo parlare,4,23373600000,23386000000,12400000,529,0,1
Amedeo Cinaglia,cinque minuti,4,23418400000,23438000000,19600000,532,0,1
Amedeo Cinaglia,al posto suo ci hanno messo taccon,4,23566800000,23586400000,19600000,533,0,1
Amedeo Cinaglia,cosa troverà su quelle carte,4,23657200000,23674800000,17600000,536,0,1
Amedeo Cinaglia,finucci,4,23704800000,23715200000,10400000,538,0,1
Amedeo Cinaglia,non sto scherzando,4,23718800000,23730400000,11600000,539,0,1
Amedeo Cinaglia,sulle carte di ostia cosa trova,4,23731200000,23757600000,26400000,540,0,1
Amedeo Cinaglia,samurai non sa un cazzo,4,24105600000,24119200000,13600000,550,1,1
Amedeo Cinaglia,che ci sta sulle carte,4,24135200000,24148400000,13200000,551,0,1
Amedeo Cinaglia,dimmelo,4,24164000000,24173200000,9200000,552,0,1
Gabriele Marchilli,ohi papà,4,24574000000,24584000000,10000000,557,0,1
Gabriele Marchilli,scusa sono dovuto andare via di corsa ma c era un amico mio che mi aspettava,4,24597600000,24636000000,38400000,558,0,1
Gabriele Marchilli,no per andare a una festa di laurea di un amica nostra,4,24652800000,24678800000,26000000,559,0,1
Gabriele Marchilli,presto papà,4,24716400000,24728000000,11600000,560,0,1
Gabriele Marchilli,la festa di laurea mia sarà presto te lo prometto,4,24750400000,24773600000,23200000,561,0,1
Gabriele Marchilli,ciao,4,24796400000,24804800000,8400000,562,0,1
Alberto Anacleti,perché m hai voluto vedere,4,25777200000,25791200000,14000000,564,0,1
Aureliano Adami,perché non m hai ammazzato,4,25841600000,25856000000,14400000,565,0,1
Alberto Anacleti,per questa stronzata mi hai fatto scomodare,4,25868400000,25889600000,21200000,566,1,1
Aureliano Adami,perché non m hai sparato spadi,4,25928400000,25944800000,16400000,567,0,1
Alberto Anacleti,non lo so,4,25957200000,25967200000,10000000,568,0,1
Aureliano Adami,ma che cazzo di risposta è non lo so,4,25992400000,26012400000,20000000,569,1,1
Alberto Anacleti,di meglio non mi viene,4,26013200000,26027600000,14400000,570,0,1
Alberto Anacleti,mi starai simpatico,4,26038800000,26052800000,14000000,571,0,1
Alberto Anacleti,che c è non mi puoi stare simpatico,4,26066000000,26084400000,18400000,572,0,1
Aureliano Adami,sì,4,26098000000,26108000000,10000000,573,0,1
Aureliano Adami,pure te mi stai simpatico,4,26115200000,26131600000,16400000,574,0,1
Aureliano Adami,però così mi stai a mettere contro tuo fratello,4,26158400000,26182000000,23600000,575,0,1
Alberto Anacleti,perché al posto mio che avresti fatto,4,26191600000,26211600000,20000000,576,0,1
Alberto Anacleti,mi avresti ammazzato,4,26215600000,26228400000,12800000,577,0,1
Alberto Anacleti,tie fuma,4,26295200000,26306800000,11600000,578,0,1
Aureliano Adami,ancora con sta cosa mi fa schifo,4,26307600000,26328400000,20800000,579,0,1
Alberto Anacleti,oh è una cannetta mica è droga,4,26337600000,26360400000,22800000,580,0,1
Alberto Anacleti,ti potresti rilassare ogni tanto sempre con sto muso,4,26369600000,26398800000,29200000,581,0,1
Aureliano Adami,sembra buona per essere degli zingari,4,26460400000,26489200000,28800000,582,0,1
Alberto Anacleti,di merda,4,26460400000,26489200000,28800000,583,1,1
Aureliano Adami,bravo,4,26490000000,26502400000,12400000,584,0,1
Alberto Anacleti,infatti la prendo da un altra parte,4,26514000000,26538400000,24400000,585,0,1
Gabriele Marchilli,sì tutto bene ho dormito poco,5,2271200000,2291200000,20000000,11,0,1
Gabriele Marchilli,niente festa in giardino stanotte,5,2315200000,2336400000,21200000,13,0,1
Gabriele Marchilli,sì,5,2409200000,2417600000,8400000,17,0,1
Gabriele Marchilli,ciao papà,5,2427200000,2440800000,13600000,18,0,1
Alberto Anacleti,sei stato te,5,2617600000,2626800000,9200000,25,0,1
Manfredi Anacleti,magari,5,2627600000,2636000000,8400000,26,0,1
Manfredi Anacleti,mi sarebbe piaciuto,5,2640400000,2652800000,12400000,27,0,1
Alberto Anacleti,e allora chi è stato,5,2661600000,2670400000,8800000,28,0,1
Manfredi Anacleti,lo vorrei proprio sapere,5,2671200000,2683600000,12400000,29,0,1
Manfredi Anacleti,tanto sono tutti convinti che siamo stati noi,5,2684400000,2706800000,22400000,30,0,1
Manfredi Anacleti,poi gira gira ci vengono a sparare fuori dalla porta di casa,5,2710400000,2736800000,26400000,31,0,1
Alberto Anacleti,chi lo prende mo il posto del vecchio,5,2770800000,2792400000,21600000,33,0,1
Manfredi Anacleti,il figlio,5,2770800000,2792400000,21600000,34,0,1
Manfredi Anacleti,quello non vede l ora di far scorrere altro sangue,5,2797200000,2819600000,22400000,35,0,1
Alberto Anacleti,forse sarebbe meglio rimandare il matrimonio,5,2863200000,2885200000,22000000,36,0,1
Manfredi Anacleti,forse sarebbe meglio che ti stai zitto il matrimonio si deve fare,5,2890400000,2922800000,32400000,37,0,1
Manfredi Anacleti,vatti a vestire,5,2940000000,2949600000,9600000,38,0,1
Amedeo Cinaglia,non ho niente,5,3688000000,3698800000,10800000,41,0,1
Amedeo Cinaglia,così però mica mi aiuti cazzo,5,3805200000,3819200000,14000000,44,1,1
Amedeo Cinaglia,scusi ha da accendere per favore,5,3884400000,3904400000,20000000,46,0,1
Amedeo Cinaglia,grazie,5,3954000000,3962400000,8400000,47,0,1
Samurai Valerio,bel negozio e bella moglie complimenti,5,4048800000,4071600000,22800000,48,0,1
Samurai Valerio,non capisco che vendete,5,4086000000,4102800000,16800000,49,0,1
Amedeo Cinaglia,profumi alla spina,5,4108000000,4118400000,10400000,50,0,1
Samurai Valerio,quelli normali non vanno più bene,5,4139600000,4159600000,20000000,51,0,1
Amedeo Cinaglia,è una cosa nuova,5,4168800000,4178800000,10000000,52,0,1
Samurai Valerio,bravo marito e bravo padre di due bambini,5,4190400000,4218800000,28400000,53,0,1
Samurai Valerio,allora quanto ci è costato questo taccon,5,4240400000,4261200000,20800000,54,0,1
Amedeo Cinaglia,taccon è uno di quelli che dice di non avere prezzo,5,4271200000,4294800000,23600000,55,0,1
Samurai Valerio,tutti ce l abbiamo un prezzo tu lo sai bene,5,4295600000,4323600000,28000000,56,0,1
Amedeo Cinaglia,io non so più niente,5,4338000000,4351200000,13200000,57,0,1
Samurai Valerio,sai quello che devi fare,5,4358400000,4373600000,15200000,58,0,1
Amedeo Cinaglia,alcuni dettagli però non li conoscevo,5,4429200000,4448800000,19600000,59,0,1
Samurai Valerio,che vuoi dire,5,4469600000,4478000000,8400000,60,0,1
Amedeo Cinaglia,niente,5,4486000000,4494400000,8400000,61,0,1
Samurai Valerio,lo sapevo che dovevo passare a trovarti,5,4536400000,4556000000,19600000,62,0,1
Samurai Valerio,non m importa come ma taccon dev essere nostro,5,4565200000,4592000000,26800000,63,0,1
Sara Monaschi,sara monaschi,5,4732800000,4752800000,20000000,65,0,0
Sara Monaschi,prego,5,4754800000,4763200000,8400000,66,0,0
Sara Monaschi,sì ma certo è per questo che io volevo parlarle,5,4833600000,4865600000,32000000,69,0,0
Sara Monaschi,sa che io lavoro in vaticano,5,4898800000,4915200000,16400000,70,0,0
Sara Monaschi,e mio marito è un imprenditore,5,4922400000,4938400000,16000000,72,0,0
Sara Monaschi,e anche lui è interessato al nuovo piano regolatore,5,4945600000,4973200000,27600000,73,0,0
Sara Monaschi,e sa anche che ho ricevuto pressioni,5,4997600000,5018000000,20400000,75,0,0
Sara Monaschi,per cedere i terreni di ostia ad una cordata di imprenditori,5,5020000000,5050800000,30800000,76,0,0
Sara Monaschi,guardi le dico chi c è dietro,5,5089600000,5110000000,20400000,78,0,0
Sara Monaschi,samurai,5,5156799999,5167200000,10400001,80,0,0
Sara Monaschi,sa chi è,5,5185600000,5202000000,16400000,81,0,0
Sara Monaschi,e allora sa anche chi ha corrotto finucci,5,5208800000,5232000000,23200000,83,0,0
Sara Monaschi,sì ma intanto lei può cambiare le cose,5,5254000000,5275200000,21200000,85,0,0
Sara Monaschi,ma mio marito non è un criminale e soprattutto dietro di lui non c è nessuno,5,5333600000,5370400000,36800000,89,0,0
Sara Monaschi,arrivederci,5,5396800000,5407200000,10400000,91,0,0
Samurai Valerio,come non si è presentato dove sta,5,5568000000,5590400000,22400000,93,0,1
Samurai Valerio,questa è una mossa della monaschi,5,5986400000,6003600000,17200000,101,0,1
Samurai Valerio,pare che dietro di lei ci sia la contessa,5,6068000000,6105200000,37200000,102,0,1
Samurai Valerio,sono io quello pericoloso eminenza,5,6158000000,6180000000,22000000,104,0,1
Samurai Valerio,è bene che nessuno se lo dimentichi,5,6187600000,6206400000,18800000,105,0,1
Alberto Anacleti,abbastanza,5,6410800000,6423600000,12800000,109,0,1
Alberto Anacleti,tanto è uguale,5,6491200000,6501200000,10000000,112,0,1
Alberto Anacleti,sempre metà letto mi tocca,5,6518000000,6540400000,22400000,114,0,1
Alberto Anacleti,mia moglie,5,6635200000,6644800000,9600000,119,0,1
Alberto Anacleti,che vuoi dire,5,6702000000,6710400000,8400000,122,0,1
Livia Adami,zitto,5,7667600000,7676000000,8400000,133,0,0
Livia Adami,t ho detto di stare zitto,5,7754400000,7772400000,18000000,137,0,0
Aureliano Adami,mo abbiamo pianto asciughiamoci le lacrime e riapriamo gli occhi,5,7933600000,7962400000,28800000,138,0,1
Aureliano Adami,voglio che stiamo attaccati a sti zingari di merda,5,7970000000,7993200000,23200000,139,1,1
Aureliano Adami,voglio sapere quanti sono dove stanno quello che fanno,5,8000400000,8025200000,24800000,140,0,1
Aureliano Adami,appena abbassano gli occhi li ammazziamo tutti,5,8032800000,8054800000,22000000,141,0,1
Aureliano Adami,uno per uno,5,8068000000,8078000000,10000000,142,0,1
Samurai Valerio,condoglianze aurelia,5,8238000000,8250000000,12000000,144,0,1
Aureliano Adami,grazie,5,8261200000,8271600000,10400000,145,0,1
Samurai Valerio,tuo padre lo conosco da quand ero pischello,5,8302400000,8322800000,20400000,146,0,1
Aureliano Adami,mmh,5,8328000000,8336400000,8400000,147,0,1
Aureliano Adami,pure io mi sa,5,8342800000,8353600000,10800000,148,0,1
Samurai Valerio,e mo che succede,5,8385600000,8396400000,10800000,149,0,1
Aureliano Adami,non lo so ci penso e te lo faccio sapere va bene,5,8418400000,8439600000,21200000,150,0,1
Samurai Valerio,non fare cazzate aurelia,5,8461600000,8480000000,18400000,151,1,1
Aureliano Adami,e no samurai le cazzate le hanno fatte gli altri mo devo sistemare le cose,5,8507200000,8543200000,36000000,152,1,1
Aureliano Adami,e tu non mi devi rompere il cazzo,5,8572800000,8591600000,18800000,153,1,1
Samurai Valerio,tullio ha sempre voluto te come capo,5,8995600000,9014400000,18800000,154,0,1
Aureliano Adami,vieni qua mettiti a sedere,5,9567200000,9581200000,14000000,157,0,1
Aureliano Adami,ma com è che samurai non abbraccia me,5,9612400000,9628400000,16000000,158,0,1
Livia Adami,falla finita aurelia,5,9633600000,9647600000,14000000,159,0,0
Livia Adami,perché hai preso i soldi di papà,5,9675600000,9690000000,14400000,160,0,0
Aureliano Adami,perché ci dobbiamo vendicare,5,9710800000,9724000000,13200000,161,0,1
Livia Adami,e lo dovevo scoprire da sola,5,9729600000,9742400000,12800000,162,0,0
Aureliano Adami,gli impicci che facevate tu e papà con samurai come li ho scoperti,5,9743200000,9770400000,27200000,163,0,1
Livia Adami,quello è un affare molto più grosso,5,9771200000,9808400000,37200000,164,0,0
Aureliano Adami,va bene ma basta è passato,5,9771200000,9808400000,37200000,165,0,1
Aureliano Adami,le cose cambiano io ho una guerra da fare,5,9826400000,9845200000,18800000,166,0,1
Aureliano Adami,non t hanno insegnato a scuola che per parlare devi alzare la mano,5,9891600000,9920400000,28800000,168,0,1
Aureliano Adami,io la tua non l ho vista,5,9930800000,9949200000,18400000,169,0,1
Livia Adami,per favore,5,9930800000,9949200000,18400000,170,0,0
Aureliano Adami,aspetta fallo parlare,5,9950000000,9963200000,13200000,171,0,1
Aureliano Adami,bravo,5,10044000000,10052400000,8400000,174,0,1
Aureliano Adami,mo vattene affanculo,5,10062000000,10075600000,13600000,175,1,1
Aureliano Adami,e non tornare più che le guerre non si fanno col pallottoliere,5,10078800000,10104000000,25200000,176,0,1
Samurai Valerio,a che punto stanno i lavori in commissione,5,10198000000,10223600000,25600000,177,0,1
Sara Monaschi,il monsignore si è preso qualche giorno di riposo,5,10243599999,10265600000,22000001,178,0,0
Sara Monaschi,è anche comprensibile dopo quello che ha passato,5,10280000000,10301600000,21600000,179,0,0
Samurai Valerio,sì ma il tempo sta per finire si riposerà dopo,5,10309200000,10337600000,28400000,180,0,1
Samurai Valerio,ora deve firmare le carte,5,10342000000,10357200000,15200000,181,0,1
Sara Monaschi,proverò a sentirlo,5,10369200000,10386800000,17600000,182,0,0
Sara Monaschi,ma purtroppo non so dove sia,5,10390799999,10405200000,14400001,183,0,0
Samurai Valerio,io invece credo di sì,5,10460000000,10475600000,15600000,184,0,1
Samurai Valerio,ho paura che lei stia seguendo i consigli sbagliati,5,10496400000,10523200000,26800000,185,0,1
Sara Monaschi,che vuol dire,5,10538400000,10547200000,8800000,186,0,0
Samurai Valerio,il tempo finisce per tutti pure per lei,5,10548000000,10569200000,21200000,187,0,1
Samurai Valerio,è meglio che lo trovi,5,10596400000,10608400000,12000000,188,0,1
Amedeo Cinaglia,e quant è che lavora con il dott taccon,5,11313600000,11334000000,20400000,191,0,1
Amedeo Cinaglia,no è solo che il dottore mi sembra un tipo piuttosto riservato,5,11359600000,11387200000,27600000,194,0,1
Amedeo Cinaglia,me ne sono accorto,5,11440800000,11452800000,12000000,197,0,1
Amedeo Cinaglia,infatti volevo trovare il modo per entrarci un po in sintonia,5,11457200000,11481600000,24400000,198,0,1
Amedeo Cinaglia,visto che dobbiamo lavorare insieme,5,11482400000,11499600000,17200000,199,0,1
Amedeo Cinaglia,non è che lei ha qualche consiglio da darmi,5,11525200000,11543200000,18000000,200,0,1
Amedeo Cinaglia,sì,5,11591200000,11599600000,8400000,202,0,1
Livia Adami,dove sta,5,12546400000,12557600000,11200000,205,0,0
Livia Adami,ancora qua stai,5,12652400000,12664400000,12000000,206,0,0
Livia Adami,stai qua solo per difendere il posto tuo,5,12704400000,12724000000,19600000,208,0,0
Livia Adami,tu e mio fratello siete uguali sempre a pensare a sto cazzo di futuro,5,12812000000,12845200000,33200000,212,1,0
Livia Adami,papà non l abbiamo ancora seppellito,5,12850400000,12867200000,16800000,213,0,0
Livia Adami,tu non lo devi nominare mio padre,5,12909600000,12924400000,14800000,216,0,0
Livia Adami,e mo vattene,5,12935600000,12946400000,10800000,217,0,0
Livia Adami,lasciami stare,5,12962800000,12973600000,10800000,218,0,0
Samurai Valerio,tutto bene,5,13226800000,13235200000,8400000,220,0,1
Samurai Valerio,la pistola,5,13273600000,13283600000,10000000,221,0,1
Gabriele Marchilli,in fondo al mare,5,13305200000,13318000000,12800000,222,0,1
Samurai Valerio,non sarà che ti ho trovato un talento che non sapevi di avere,5,13350800000,13378800000,28000000,223,0,1
Gabriele Marchilli,il debito l ho pagato siamo a posto,5,13402400000,13430400000,28000000,224,0,1
Samurai Valerio,a posto,5,13437600000,13447200000,9600000,225,0,1
Gabriele Marchilli,bene allora io posso andare,5,13462000000,13478000000,16000000,226,0,1
Samurai Valerio,no,5,13485600000,13494000000,8400000,227,0,1
Samurai Valerio,hai ucciso un boss su ordine mio,5,13500000000,13521200000,21200000,228,0,1
Samurai Valerio,perché sei ancora vivo lo sai,5,13536400000,13552800000,16400000,229,0,1
Samurai Valerio,perché mi servi ancora,5,13566000000,13577600000,11600000,230,0,1
Samurai Valerio,tu da oggi sei gli occhi e le orecchie mie dentro la famiglia adami,5,13598000000,13628000000,30000000,231,0,1
Samurai Valerio,mi devi dire tutto soprattutto quello che fa aureliano,5,13632800000,13661200000,28400000,232,0,1
Samurai Valerio,hai capito,5,13674800000,13683200000,8400000,233,0,1
Samurai Valerio,ora puoi andare,5,13722800000,13732400000,9600000,234,0,1
Aureliano Adami,grazie di essere passato,5,14385200000,14400800000,15600000,243,0,1
Gabriele Marchilli,mi dispiace,5,14414400000,14423600000,9200000,244,0,1
Gabriele Marchilli,chi è stato lo sai,5,14470800000,14482000000,11200000,245,0,1
Aureliano Adami,gli zingari chi vuoi che è stato,5,14490800000,14505600000,14800000,246,0,1
Gabriele Marchilli,e adesso,5,14552800000,14562000000,9200000,247,0,1
Gabriele Marchilli,che vuoi fare,5,14569200000,14580400000,11200000,248,0,1
Aureliano Adami,li voglio ammazzare tutti,5,14584800000,14598000000,13200000,249,0,1
Gabriele Marchilli,e tu,5,14668400000,14677600000,9200000,250,0,1
Gabriele Marchilli,come stai,5,14690000000,14701200000,11200000,251,0,1
Aureliano Adami,come quando odii qualcuno,5,14719200000,14735200000,16000000,252,0,1
Aureliano Adami,all improvviso non ci sta più,5,14794400000,14810800000,16400000,253,0,1
Aureliano Adami,e ti accorgi che ti manca,5,14836400000,14853600000,17200000,254,0,1
Aureliano Adami,perché non lo puoi neanche più odiare,5,14886800000,14905200000,18400000,255,0,1
Gabriele Marchilli,comunque io sto qua,5,15011200000,15021600000,10400000,256,0,1
Aureliano Adami,mo comando io,5,15194800000,15206000000,11200000,257,0,1
Aureliano Adami,e lo devono sapere tutti,5,15253200000,15266000000,12800000,258,0,1
Contessa Sveva Della Rocca Croce,com è andata,5,15448000000,15458400000,10400000,261,0,0
Contessa Sveva Della Rocca Croce,com è andata con samurai,5,15472400000,15488400000,16000000,262,0,0
Sara Monaschi,dice che ha fretta,5,15497600000,15510000000,12400000,263,0,0
Sara Monaschi,sospetta e mi ha anche minacciata,5,15520800000,15540400000,19600000,264,0,0
Contessa Sveva Della Rocca Croce,appena taccon scopre chi c è dietro le sue ditte,5,15541200000,15566400000,25200000,265,0,0
Contessa Sveva Della Rocca Croce,vedrai come samurai torna educato,5,15567200000,15586400000,19200000,266,0,0
Contessa Sveva Della Rocca Croce,e allora tratterà,5,15593200000,15605200000,12000000,267,0,0
Contessa Sveva Della Rocca Croce,sara tu sei distratta che succede,5,15626400000,15651200000,24800000,268,0,0
Contessa Sveva Della Rocca Croce,è per samurai o c è dell altro,5,15658000000,15674000000,16000000,269,0,0
Sara Monaschi,ma no è che sono preoccupata,5,15681200000,15700800000,19600000,270,0,0
Contessa Sveva Della Rocca Croce,non è che mi sto sbagliando a scommettere tutto su di te,5,15737600000,15766800000,29200000,271,0,0
Contessa Sveva Della Rocca Croce,il mio solito tè bianco con una puntina di zenzero,5,15782400000,15813600000,31200000,273,0,0
Sara Monaschi,per me lo stesso grazie,5,15831600000,15844000000,12400000,274,0,0
Sara Monaschi,perché vuole fregare samurai,5,15870000000,15889200000,19200000,275,0,0
Contessa Sveva Della Rocca Croce,perché lui ha rovinato me e mio marito,5,15916000000,15941200000,25200000,276,0,0
Sara Monaschi,come,5,15956400000,15965200000,8800000,277,0,0
Contessa Sveva Della Rocca Croce,ricordi la famosa rapina di samurai,5,15993600000,16011600000,18000000,278,0,0
Sara Monaschi,sì,5,16022400000,16030800000,8400000,279,0,0
Contessa Sveva Della Rocca Croce,il vero obiettivo non erano i gioielli ma certi documenti,5,16042000000,16073600000,31600000,280,0,0
Contessa Sveva Della Rocca Croce,coi gioielli ti compri mezza roma ma coi segreti te la prendi tutta,5,16082800000,16119200000,36400000,281,0,0
Contessa Sveva Della Rocca Croce,e lui se l è presa,5,16120000000,16132000000,12000000,282,0,0
Contessa Sveva Della Rocca Croce,e si è preso pure le aziende di mio marito,5,16136800000,16157200000,20400000,283,0,0
Contessa Sveva Della Rocca Croce,che alla fine si è ammazzato,5,16181600000,16200400000,18800000,284,0,0
Contessa Sveva Della Rocca Croce,tieni gli occhi aperti che samurai non l abbiamo ancora fregato,5,16226800000,16256000000,29200000,285,0,0
Livia Adami,hai ragione tu,5,16324800000,16337200000,12400000,286,0,0
Livia Adami,prima aureliano,5,16342400000,16352800000,10400000,287,0,0
Livia Adami,e poi gli zingari di merda,5,16359600000,16376800000,17200000,288,1,0
Livia Adami,una guerra alla volta,5,16388800000,16399600000,10800000,289,0,0
Livia Adami,aureliano si è preso i soldi che stavano in mezzo alle dune,5,16426800000,16454000000,27200000,291,0,0
Livia Adami,ma degli affari miei non sa un cazzo,5,16454800000,16472400000,17600000,292,1,0
Livia Adami,mi devi portare tutti i conti della famiglia,5,16482000000,16502400000,20400000,293,0,0
Livia Adami,devo sapere fino a che punto mi posso spingere,5,16511600000,16534000000,22400000,294,0,0
Livia Adami,prima voglio parlare con le famiglie di ostia che lavorano per noi,5,16573600000,16602800000,29200000,296,0,0
Livia Adami,mi devono appoggiare,5,16613600000,16625200000,11600000,297,0,0
Livia Adami,che vuoi in cambio del tuo appoggio,5,16924800000,16944800000,20000000,300,0,0
Samurai Valerio,appoggio è una parola brutta la usano i politici,5,16961600000,16986000000,24400000,301,0,1
Samurai Valerio,diciamo che io ti aiuto a salire sul trono che ti spetta,5,16991200000,17019200000,28000000,302,0,1
Livia Adami,e in cambio,5,17037200000,17048800000,11600000,303,0,0
Samurai Valerio,niente più sangue,5,17051600000,17064800000,13200000,304,0,1
Samurai Valerio,nessuna vendetta sugli zingari,5,17065600000,17086000000,20400000,305,0,1
Samurai Valerio,oltre a quello che mi aveva promesso tuo padre su ostia,5,17093200000,17119200000,26000000,306,0,1
Livia Adami,guarda che il trono di papà non è un seggiolone,5,17150800000,17173200000,22400000,307,0,0
Livia Adami,e io non sono più una ragazzina,5,17178400000,17194800000,16400000,308,0,0
Samurai Valerio,che vuoi dire,5,17205600000,17217200000,11600000,309,0,1
Livia Adami,che sul trono di mio padre mi ci siedo da sola non ho bisogno dell aiuto tuo,5,17221200000,17254800000,33600000,310,0,0
Samurai Valerio,e che saresti venuta a fare,5,17262000000,17278000000,16000000,311,0,1
Livia Adami,a dirti che mio padre non lo vendico proprio come vuoi tu,5,17304800000,17332000000,27200000,312,0,0
Livia Adami,ma in cambio voglio l 8 sull affare di ostia,5,17349600000,17374000000,24400000,313,0,0
Manfredi Anacleti,fai scendere gli sposi,5,17636000000,17654000000,18000000,319,0,1
Manfredi Anacleti,maestro,5,17772800000,17786000000,13200000,323,0,1
Manfredi Anacleti,maestro facciamo un lento per favore,5,17786800000,17823600000,36800000,324,0,1
Manfredi Anacleti,mio fratello è un uomo fortunato,5,18127200000,18142400000,15200000,329,0,1
Manfredi Anacleti,viva gli sposi,5,18278400000,18299200000,20800000,330,0,1
Manfredi Anacleti,vai spadi,5,18332000000,18344800000,12800000,332,0,1
Aureliano Adami,che cazzo è tutta sta gente,5,18977200000,18993600000,16400000,336,1,1
Aureliano Adami,mo sì che ti riconosco sorellina,5,19405200000,19426800000,21600000,338,0,1
Aureliano Adami,che schifo mi fai,5,19518000000,19534000000,16000000,339,0,1
Amedeo Cinaglia,buonasera,5,19786800000,19802800000,16000000,341,0,1
Amedeo Cinaglia,volevo solo capire quando potevamo vederci per coordinare i lavori,5,19849600000,19881600000,32000000,343,0,1
Amedeo Cinaglia,che fine ha fatto quel suo progetto sui musei di roma,5,19928400000,19953600000,25200000,346,0,1
Amedeo Cinaglia,me lo ricordo bene,5,20018800000,20029600000,10800000,349,0,1
Amedeo Cinaglia,era un bel progetto,5,20034400000,20044000000,9600000,350,0,1
Amedeo Cinaglia,ci pensa mai,5,20060400000,20070400000,10000000,351,0,1
Amedeo Cinaglia,era un simbolo roma i lupi l hanno fondata,5,20177200000,20206000000,28800000,355,0,1
Amedeo Cinaglia,prima mi ha detto che non aveva ancora visto le carte,5,20307200000,20330800000,23600000,359,0,1
Amedeo Cinaglia,noi non siamo lupi,5,20390800000,20403200000,12400000,361,0,1
Amedeo Cinaglia,ma lei cosa farebbe se oggi le offrissero,5,20476000000,20496399999,20399999,364,0,1
Amedeo Cinaglia,di realizzare il suo progetto sui musei di roma,5,20497199999,20520000000,22800001,365,0,1
Amedeo Cinaglia,buonanotte,5,20598400000,20610400000,12000000,369,0,1
Gabriele Marchilli,adesso posso sapere perché mi hai chiamato,5,20924000000,20944000000,20000000,371,0,1
Sara Monaschi,perché stavi là da samurai,5,20969600000,20986000000,16400000,372,0,0
Gabriele Marchilli,il debito ce l avevo con lui,5,20999600000,21014400000,14800000,373,0,1
Gabriele Marchilli,ora è tutto risolto,5,21027200000,21040000000,12800000,374,0,1
Sara Monaschi,tutto qua,5,21062800000,21071200000,8400000,375,0,0
Gabriele Marchilli,tutto qua,5,21080800000,21089200000,8400000,376,0,1
Gabriele Marchilli,e tu che ci facevi al maneggio,5,21102000000,21115600000,13600000,377,0,1
Sara Monaschi,niente d importante,5,21122000000,21132000000,10000000,378,0,0
Gabriele Marchilli,niente d importante con samurai,5,21175200000,21192400000,17200000,379,0,1
Gabriele Marchilli,sara perché siamo qua,5,21256000000,21270400000,14400000,380,0,1
Sara Monaschi,perché ero preoccupata per te,5,21277200000,21294800000,17600000,381,0,0
Sara Monaschi,io quando t ho visto lì ho avuto paura,5,21314000000,21339200000,25200000,382,0,0
Gabriele Marchilli,paura e di che,5,21370400000,21391200000,20800000,383,0,1
Sara Monaschi,non lo so,5,21416400000,21426000000,9600000,384,0,0
Gabriele Marchilli,ora me lo dici perché siamo qua,5,21479600000,21495600000,16000000,385,0,1
Livia Adami,oh,5,21790000000,21800400000,10400000,387,0,0
Livia Adami,dove vai,5,21823200000,21832000000,8800000,388,0,0
Livia Adami,vieni qua,5,21872800000,21883200000,10400000,390,0,0
Livia Adami,ti volevo ringraziare,5,21974800000,21986400000,11600000,392,0,0
Livia Adami,senza di te non avrei fatto niente,5,22012400000,22034400000,22000000,393,0,0
Manfredi Anacleti,mo devi fare l uomo fatti onore,5,22695200000,22717200000,22000000,400,0,1
Aureliano Adami,li ammazzo tutti,5,22955200000,22973600000,18400000,403,0,1
Aureliano Adami,m hanno inculato,5,22999600000,23010000000,10400000,405,0,1
Aureliano Adami,samurai mio padre mia sorella tutti,5,23014800000,23034400000,19600000,406,0,1
Aureliano Adami,calmati un cazzo non ho più niente mi hanno levato tutto,5,23053600000,23080800000,27200000,408,1,1
Aureliano Adami,sono solo come un cane,5,23110000000,23122800000,12800000,409,0,1
Amedeo Cinaglia,guarda che lo so che non dormi,5,23705600000,23720000000,14400000,410,0,1
Amedeo Cinaglia,a prenderti questi,5,23862400000,23874800000,12400000,412,0,1
Amedeo Cinaglia,lo so,5,23929200000,23937600000,8400000,414,0,1
Amedeo Cinaglia,quello chi,5,24060000000,24070400000,10400000,416,0,1
Amedeo Cinaglia,ma no quello è uno che voleva un favore,5,24146400000,24165600000,19200000,419,0,1
Amedeo Cinaglia,stai tranquilla,5,24174000000,24183600000,9600000,420,0,1
Gabriele Marchilli,ohi papà,5,24430800000,24440400000,9600000,424,0,1
Gabriele Marchilli,ehi cambia che è sto schifo,5,24510800000,24531200000,20400000,427,0,1
Gabriele Marchilli,oh,5,24669600000,24678000000,8400000,433,0,1
Gabriele Marchilli,quante bugie mi hai raccontato,5,24685200000,24702000000,16800000,434,0,1
Gabriele Marchilli,mo basta,5,24716400000,24727200000,10800000,435,0,1
Gabriele Marchilli,perché poi la testa pensa e ripensa a tutte le cose strane che sono successe,5,24728000000,24766000000,38000000,436,0,1
Gabriele Marchilli,torni tardi la sera,5,24766800000,24780000000,13200000,437,0,1
Gabriele Marchilli,hai sfondato la macchina,5,24784000000,24798000000,14000000,438,0,1
Gabriele Marchilli,e mi rispondi pure,5,24815600000,24827200000,11600000,440,0,1
Gabriele Marchilli,sai che c è di nuovo gabrie,5,24846000000,24859600000,13600000,441,0,1
Gabriele Marchilli,da oggi le fregnacce tue non me le bevo più,5,24867600000,24885600000,18000000,442,0,1
Gabriele Marchilli,da oggi sei te che decidi chi cazzo vuoi essere nella vita,5,24886400000,24911600000,25200000,443,1,1
Gabriele Marchilli,io non voglio più sapere niente,5,24915200000,24931200000,16000000,444,0,1
Gabriele Marchilli,io ho scelto di non essere come te,5,24941200000,24956800000,15600000,446,0,1
Angelica Sale,non è proprio come me lo sono sognato,5,26346800000,26366800000,20000000,453,0,0
Alberto Anacleti,e com era,5,26390000000,26400800000,10800000,454,0,1
Angelica Sale,beh un po più movimentato,5,26429200000,26444400000,15200000,455,0,0
Alberto Anacleti,così eh,5,26528400000,26546400000,18000000,456,0,1
Alberto Anacleti,così eh,5,26611200000,26629600000,18400000,457,0,1
Alberto Anacleti,così,5,26655200000,26668000000,12800000,458,0,1
Alberto Anacleti,così,5,26679200000,26692000000,12800000,460,0,1
Angelica Sale,ma che succede,5,26836000000,26850400000,14400000,462,0,0
Angelica Sale,oh,5,26882000000,26890400000,8400000,463,0,0
Angelica Sale,almeno mi guardi,5,26903200000,26917200000,14000000,464,0,0
Angelica Sale,che cazzo stai a fare,5,26966400000,26983200000,16800000,465,1,0
Angelica Sale,albe non fare cazzate eh,5,26984000000,26998000000,14000000,466,1,0
Angelica Sale,oh,5,27004400000,27013600000,9200000,467,0,0
Alberto Anacleti,non lo deve sapere nessuno,5,27310000000,27325200000,15200000,469,0,1
Alberto Anacleti,intesi,5,27336000000,27346400000,10400000,470,0,1
Samurai Valerio,allora taccon è nostro,5,27517600000,27533600000,16000000,471,0,1
Amedeo Cinaglia,so come gestirlo,5,27540000000,27553600000,13600000,472,0,1
Samurai Valerio,bene bravo,5,27554400000,27572400000,18000000,473,0,1
Amedeo Cinaglia,forse però c è un problema,5,27586000000,27600400000,14400000,474,0,1
Samurai Valerio,sentiamo,5,27604000000,27614400000,10400000,475,0,1
Amedeo Cinaglia,vuole bloccare tutto,5,27622000000,27634800000,12800000,476,0,1
Amedeo Cinaglia,dice che c è qualcosa di poco chiaro dietro le ditte,5,27644400000,27669200000,24800000,477,0,1
Amedeo Cinaglia,io so cosa scoprirà,5,27689600000,27703600000,14000000,478,0,1
Samurai Valerio,e che deve scoprire sto stronzo,5,27709200000,27726400000,17200000,479,1,1
Amedeo Cinaglia,che dietro c è la mafia,5,27739200000,27752400000,13200000,480,0,1
Amedeo Cinaglia,a taccon ci penso io,5,27805200000,27819600000,14400000,481,0,1
Amedeo Cinaglia,però voglio rivedere i patti,5,27837600000,27852400000,14800000,482,0,1
Samurai Valerio,non hai fatto ancora un cazzo cina,5,27873200000,27892000000,18800000,483,1,1
Samurai Valerio,e lo decido io cosa è giusto e cosa no,5,27899600000,27921200000,21600000,484,0,1
Manfredi Anacleti,no,5,28215200000,28225200000,10000000,485,0,1
Manfredi Anacleti,oggi no solo per oggi devi servire per primo tuo marito,5,28230800000,28258800000,28000000,486,0,1
Manfredi Anacleti,stanotte t ha fatto femmina e va a lui pure quest altro onore,5,28272800000,28299200000,26400000,487,0,1
Gabriele Marchilli,cazzo,5,29005200000,29015600000,10400000,491,1,1
Aureliano Adami,pare che mi sta fissando pure da là dentro,5,29579200000,29600800000,21600000,492,0,1
Aureliano Adami,mi vorrebbe fare la predica come al solito,5,29617200000,29636800000,19600000,493,0,1
Livia Adami,stavolta la farebbe a tutti e due,5,29650800000,29669600000,18800000,494,0,0
Aureliano Adami,no,5,29705600000,29714000000,8400000,495,0,1
Aureliano Adami,sarebbe contento,5,29738400000,29751600000,13200000,496,0,1
Livia Adami,perché è giusto così,5,29792000000,29806800000,14800000,497,0,0
Aureliano Adami,è giusto per te,5,29834400000,29848800000,14400000,498,0,1
Livia Adami,posto per te in famiglia ci sta e ci starà sempre aurelia,5,29903600000,29932800000,29200000,499,0,0
Aureliano Adami,pure per te il posto in famiglia ci sarà sempre,5,30018400000,30042000000,23600000,500,0,1
Gabriele Marchilli,t ha chiamato pure a te,5,31157200000,31168400000,11200000,502,0,1
Alberto Anacleti,sai che vuole,5,31184400000,31194400000,10000000,503,0,1
Gabriele Marchilli,no,5,31219600000,31228000000,8400000,504,0,1
Aureliano Adami,tocca che torniamo insieme,5,31916400000,31932400000,16000000,506,0,1
Alberto Anacleti,cioè,5,31984400000,31994000000,9600000,507,0,1
Aureliano Adami,cioè ripartiamo da zio prete,5,31994800000,32012400000,17600000,508,0,1
Aureliano Adami,ma stavolta non gli leviamo i soldi gli leviamo i terreni,5,32029600000,32056000000,26400000,509,0,1
Alberto Anacleti,mmh,5,32073600000,32082000000,8400000,510,0,1
Alberto Anacleti,e per farci che,5,32086800000,32095200000,8400000,511,0,1
Aureliano Adami,per sputare in faccia a un po di gente spadi,5,32099600000,32121600000,22000000,512,0,1
Aureliano Adami,a samurai per primo,5,32131200000,32144000000,12800000,513,0,1
Aureliano Adami,poi io a mia sorella,5,32161600000,32176400000,14800000,514,0,1
Aureliano Adami,te a quella merda di tuo fratello,5,32181200000,32198400000,17200000,515,1,1
Aureliano Adami,e te che cazzo ne so ci sarà qualcuno a cui vuoi sputare in faccia,5,32203200000,32230800000,27600000,516,1,1
Aureliano Adami,chiudiamo con le famiglie e ci riprendiamo la vita nostra,5,32259600000,32282000000,22400000,517,0,1
Gabriele Marchilli,ma che cazzo stai a dire,5,32312800000,32322800000,10000000,518,1,1
Aureliano Adami,sto posto è della famiglia mia tutto intorno è del prete,5,32349600000,32374000000,24400000,519,0,1
Aureliano Adami,noi ci prendiamo tutto diventa tutta roba nostra,5,32374800000,32396400000,21600000,520,0,1
Aureliano Adami,ma stavolta non si gioca,5,32420800000,32434400000,13600000,521,0,1
Aureliano Adami,ci verranno sotto tutti politici preti e pure quella faccia di merda di samurai,5,32450000000,32484000000,34000000,522,1,1
Aureliano Adami,ci state,5,32550000000,32558400000,8400000,523,0,1
Aureliano Adami,sì o no,5,32643600000,32652800000,9200000,524,0,1
Alberto Anacleti,dai,5,32733600000,32742800000,9200000,525,0,1
Gabriele Marchilli,dai,5,32822400000,32833200000,10800000,526,0,1
Aureliano Adami,dai,5,32867600000,32876800000,9200000,527,0,1
Sara Monaschi,monsignore,6,642800000,651200000,8400000,1,0,0
Sara Monaschi,ma adesso sono io che prego lei venga via venga qua,6,682800000,711600000,28800000,3,0,0
Sara Monaschi,venga qui da me,6,722000000,732800000,10800000,4,0,0
Sara Monaschi,la prego,6,736400000,745600000,9200000,5,0,0
Sara Monaschi,non c è niente a cui non si possa porre rimedio,6,771200000,793600000,22400000,6,0,0
Sara Monaschi,il signore perdona,6,801600000,815600000,14000000,7,0,0
Sara Monaschi,gli uomini perdonano,6,831200000,845600000,14400000,8,0,0
Sara Monaschi,mi fermo,6,1038800000,1049200000,10400000,13,0,0
Sara Monaschi,ma lei resti lì dov è,6,1066000000,1079600000,13600000,14,0,0
Sara Monaschi,adesso noi torniamo a roma,6,1109600000,1123600000,14000000,15,0,0
Sara Monaschi,la chiesa l aiuterà a sparire,6,1145600000,1164000000,18400000,17,0,0
Sara Monaschi,a ritirarsi,6,1167600000,1180800000,13200000,18,0,0
Sara Monaschi,lei non esisterà più per nessuno,6,1190800000,1206000000,15200000,19,0,0
Sara Monaschi,ripenserà a questo momento e magari starà dicendo messa,6,1230400000,1259600000,29200000,20,0,0
Sara Monaschi,in qualche posto sperduto,6,1260400000,1276400000,16000000,21,0,0
Sara Monaschi,in una chiesetta di campagna,6,1288400000,1300800000,12400000,22,0,0
Sara Monaschi,e studierà pregherà,6,1324400000,1342400000,18000000,23,0,0
Sara Monaschi,una nuova vita,6,1412000000,1425600000,13600000,24,0,0
Sara Monaschi,lontano da tutto,6,1440000000,1450400000,10400000,25,0,0
Sara Monaschi,puoi tornare a casa tua in grecia,6,1492400000,1509200000,16800000,26,0,0
Sara Monaschi,dammi la mano ti prego,6,1513600000,1531200000,17600000,27,0,0
Sara Monaschi,dammi la mano,6,1540800000,1550000000,9200000,28,0,0
Sara Monaschi,vieni,6,1555200000,1563600000,8400000,29,0,0
Sara Monaschi,vieni,6,1572000000,1580800000,8800000,30,0,0
Sara Monaschi,dai,6,1590000000,1598400000,8400000,31,0,0
Sara Monaschi,dammi la mano,6,1602000000,1613200000,11200000,32,0,0
Sara Monaschi,ehi,6,2068000000,2079200000,11200000,33,0,0
Gabriele Marchilli,ciao,6,2068000000,2079200000,11200000,34,0,1
Sara Monaschi,allora è vero che non puoi vivere senza di me,6,2091600000,2114400000,22800000,35,0,0
Sara Monaschi,che è successo,6,2142800000,2153200000,10400000,36,0,0
Gabriele Marchilli,niente perché,6,2159200000,2174400000,15200000,37,0,1
Sara Monaschi,hai una faccia,6,2184800000,2197200000,12400000,38,0,0
Gabriele Marchilli,ho dormito poco,6,2201600000,2212400000,10800000,39,0,1
Sara Monaschi,allora dove mi porti,6,2236000000,2254400000,18400000,41,0,0
Gabriele Marchilli,è una sorpresa,6,2257200000,2267600000,10400000,42,0,1
Manfredi Anacleti,spadino,6,2421600000,2431200000,9600000,44,0,1
Angelica Sale,dev essere uscito presto,6,2450800000,2462800000,12000000,45,0,0
Manfredi Anacleti,per andare dove,6,2465600000,2484000000,18400000,46,0,1
Angelica Sale,non lo so,6,2465600000,2484000000,18400000,47,0,0
Manfredi Anacleti,non lo sai,6,2487600000,2496400000,8800000,48,0,1
Manfredi Anacleti,una moglie deve sempre sapere dove sta il marito,6,2497200000,2518000000,20800000,49,0,1
Manfredi Anacleti,e lo deve fare contento,6,2536800000,2548800000,12000000,50,0,1
Manfredi Anacleti,vieni qua,6,2560400000,2569200000,8800000,51,0,1
Manfredi Anacleti,vieni qua mica ti mordo vieni,6,2578399999,2596400000,18000001,52,0,1
Manfredi Anacleti,avvicinati,6,2611200000,2619599999,8399999,53,0,1
Manfredi Anacleti,tieni,6,2682800000,2691200000,8400000,54,0,1
Manfredi Anacleti,dai prendili comprati qualcosa di carino,6,2697200000,2716000000,18800000,55,0,1
Manfredi Anacleti,la mercanzia ce l hai mettila in mostra no,6,2778800000,2798000000,19200000,56,0,1
Sara Monaschi,beh sarebbe questa la sorpresa,6,2978800000,2998400000,19600000,58,0,0
Aureliano Adami,no,6,2999200000,3008400000,9200000,59,0,1
Aureliano Adami,siamo noi la sorpresa,6,3024400000,3037600000,13200000,60,0,1
Gabriele Marchilli,tranquilla adesso ti spiego tutto,6,3090000000,3109600000,19600000,61,0,1
Sara Monaschi,che mi devi spiegare,6,3117600000,3130400000,12800000,62,0,0
Sara Monaschi,che sei un pezzo di merda,6,3131200000,3146000000,14800000,63,1,0
Sara Monaschi,eh eri d accordo con questi due fin dall inizio,6,3151200000,3176400000,25200000,64,0,0
Sara Monaschi,stronzo,6,3180400000,3192400000,12000000,65,1,0
Gabriele Marchilli,sara,6,3180400000,3192400000,12000000,66,0,1
Sara Monaschi,stronzo,6,3193200000,3203200000,10000000,67,1,0
Alberto Anacleti,ammazza che sberla,6,3204000000,3225200000,21200000,68,0,1
Sara Monaschi,andatevene affanculo perché io non ho niente da dirvi,6,3230400000,3254400000,24000000,69,1,0
Aureliano Adami,invece mi sa di sì,6,3255200000,3267600000,12400000,70,0,1
Gabriele Marchilli,oh che cazzo fai,6,3272400000,3289600000,17200000,71,1,1
Aureliano Adami,statti zitto,6,3272400000,3289600000,17200000,72,0,1
Aureliano Adami,che dobbiamo fare,6,3310000000,3319600000,9600000,73,0,1
Aureliano Adami,pensaci bene,6,3418800000,3430000000,11200000,74,0,1
Aureliano Adami,a dove sta sto prete che magari ti torna in mente,6,3436000000,3458400000,22400000,75,0,1
Sara Monaschi,ti ho detto che non lo so,6,3473200000,3486400000,13200000,76,0,0
Alberto Anacleti,ma ti conviene proteggere quel bagarozzo di merda,6,3498800000,3531600000,32800000,77,1,1
Sara Monaschi,e poi che volete da lui scusa,6,3541200000,3555200000,14000000,78,0,0
Aureliano Adami,i terreni di ostia,6,3569200000,3580400000,11200000,79,0,1
Sara Monaschi,che cosa,6,3598000000,3606400000,8400000,80,0,0
Aureliano Adami,ma che parlo un altra lingua io,6,3619600000,3634800000,15200000,81,0,1
Alberto Anacleti,ha capito,6,3635600000,3652000000,16400000,82,0,1
Alberto Anacleti,devi convincere la commissione a non rompere i coglioni,6,3652800000,3680400000,27600000,83,1,1
Sara Monaschi,i terreni di ostia,6,3684000000,3696800000,12800000,84,0,0
Sara Monaschi,ma che è uno scherzo,6,3705200000,3718000000,12800000,85,0,0
Sara Monaschi,la commissione non assegnerà mai quei terreni a voi tre,6,3731600000,3757200000,25600000,86,0,0
Sara Monaschi,è impossibile,6,3762000000,3770800000,8800000,87,0,0
Aureliano Adami,e perché,6,3771600000,3780800000,9200000,88,0,1
Aureliano Adami,è di preti e di chiesa che parliamo,6,3795600000,3812400000,16800000,89,0,1
Aureliano Adami,quelli è una vita che fanno come cazzo gli pare,6,3813200000,3833200000,20000000,90,1,1
Sara Monaschi,siete pazzi,6,3838400000,3849600000,11200000,91,0,0
Aureliano Adami,però quei terreni o ce li prendiamo noi o non se li prende nessuno,6,3866800000,3894000000,27200000,92,0,1
Aureliano Adami,quindi dimmi dove sta sto prete forza,6,3914000000,3931200000,17200000,93,0,1
Aureliano Adami,senti mo m hai rotto il cazzo vieni qua,6,3983600000,4003600000,20000000,94,1,1
Aureliano Adami,se non mi dici dove sta questo,6,4018000000,4030800000,12800000,95,0,1
Aureliano Adami,io ti sparo in faccia ti butto nel fiume e non ti trovano più,6,4031600000,4056800000,25200000,96,0,1
Sara Monaschi,e poi come fai,6,4072400000,4082000000,9600000,97,0,0
Sara Monaschi,io conosco il vaticano,6,4097600000,4111600000,14000000,98,0,0
Sara Monaschi,io so come ragionano so come muovermi là dentro,6,4117600000,4144800000,27200000,99,0,0
Sara Monaschi,vi posso pure far entrare in quest affare ma ho bisogno di tempo,6,4153200000,4182000000,28800000,100,0,0
Sara Monaschi,per capire come per trovare una soluzione,6,4182800000,4216400000,33600000,101,0,0
Sara Monaschi,ahi,6,4217200000,4229600000,12400000,102,0,0
Aureliano Adami,hai un sacco di tempo,6,4217200000,4229600000,12400000,103,0,1
Gabriele Marchilli,forse dovremmo fare come dice lei no,6,4230400000,4246800000,16400000,104,0,1
Gabriele Marchilli,ha ragione lei conosce quelle persone,6,4254400000,4274000000,19600000,105,0,1
Gabriele Marchilli,e poi che abbiamo da perdere,6,4293200000,4308000000,14800000,106,0,1
Gabriele Marchilli,magari trova una soluzione che fa contenti a tutti,6,4315200000,4338800000,23600000,107,0,1
Gabriele Marchilli,a riprenderla facciamo sempre in tempo,6,4357600000,4376400000,18800000,108,0,1
Aureliano Adami,se fa una cazzata me la prendo con te,6,4435200000,4452000000,16800000,109,1,1
Sara Monaschi,tu vedi di sbrigarti,6,4488800000,4502800000,14000000,110,0,0
Alberto Anacleti,buh,6,4556800000,4566000000,9200000,111,0,1
Amedeo Cinaglia,ciao ste posso,6,5188800000,5204000000,15200000,114,0,1
Amedeo Cinaglia,come stai,6,5266400000,5276000000,9600000,116,0,1
Amedeo Cinaglia,ti trovo invecchiato,6,5287600000,5296800000,9200000,117,0,1
Amedeo Cinaglia,no sono invecchiato anche io invece,6,5329200000,5348400000,19200000,119,0,1
Amedeo Cinaglia,ti faccio compagnia,6,5349200000,5377600000,28400000,121,0,1
Amedeo Cinaglia,e quella volta che hai pranzato con ferinelli,6,5413600000,5432800000,19200000,123,0,1
Amedeo Cinaglia,io penso di sì invece,6,5470800000,5484400000,13600000,125,0,1
Amedeo Cinaglia,ti ricordi di quello strano pranzo che hai organizzato tanti anni fa,6,5500000000,5529600000,29600000,126,0,1
Amedeo Cinaglia,con quel lobbista molto particolare un grande sostenitore dell eolico,6,5532400000,5564400000,32000000,127,0,1
Amedeo Cinaglia,se ne parlò tanto all epoca,6,5577200000,5591200000,14000000,128,0,1
Amedeo Cinaglia,poi però finì tutto nel dimenticatoio anche le foto tue e di lui,6,5601200000,5630400000,29200000,129,0,1
Amedeo Cinaglia,poco dopo però le pale iniziarono a girare in mezza italia,6,5636800000,5667600000,30800000,130,0,1
Amedeo Cinaglia,tu lo sai come si dice no,6,5670400000,5682400000,12000000,131,0,1
Amedeo Cinaglia,a pensare male si fa peccato ma molto spesso ci si azzecca,6,5688400000,5716400000,28000000,132,0,1
Amedeo Cinaglia,no,6,5754800000,5763200000,8400000,134,0,1
Amedeo Cinaglia,voglio che usi tutto il potere che hai conquistato in questi anni,6,5768800000,5795600000,26800000,135,0,1
Amedeo Cinaglia,per affidare la direzione dei musei di roma a un amico comune,6,5796400000,5822800000,26400000,136,0,1
Amedeo Cinaglia,ma come non sei curioso di sapere chi è l amico,6,5858400000,5880000000,21600000,138,0,1
Amedeo Cinaglia,è taccon,6,5894800000,5903600000,8800000,139,0,1
Amedeo Cinaglia,il povero taccon ha sempre desiderato quel posto,6,5918400000,5939200000,20800000,140,0,1
Amedeo Cinaglia,solo che il partito aveva altri piani altri raccomandati,6,5940000000,5970800000,30800000,141,0,1
Amedeo Cinaglia,il diavolo ha pure la tua,6,6007600000,6020400000,12800000,143,0,1
Amedeo Cinaglia,quanto t hanno dato per far girare quelle pale eh,6,6021200000,6048000000,26800000,144,0,1
Amedeo Cinaglia,mi ha fatto piacere rivederti stefano,6,6146000000,6171200000,25200000,148,0,1
Amedeo Cinaglia,meglio dell ultima volta che ci siamo visti no,6,6172000000,6193200000,21200000,150,0,1
Amedeo Cinaglia,t ho spaccato la faccia,6,6198400000,6212800000,14400000,151,0,1
Amedeo Cinaglia,beh allora vediamo che succede la prossima volta,6,6297600000,6321600000,24000000,153,0,1
Amedeo Cinaglia,aspetto tue notizie,6,6400400000,6413600000,13200000,154,0,1
Amedeo Cinaglia,diciamo entro stasera,6,6422800000,6435200000,12400000,155,0,1
Gabriele Marchilli,sara per favore parliamo,6,6677600000,6693600000,16000000,156,0,1
Sara Monaschi,zitto,6,6677600000,6693600000,16000000,157,0,0
Gabriele Marchilli,mi dispiace veramente,6,6698400000,6708400000,10000000,158,0,1
Sara Monaschi,stai zitto ho detto,6,6709200000,6723200000,14000000,159,0,0
Sara Monaschi,io non ci posso credere,6,6731600000,6744400000,12800000,160,0,0
Sara Monaschi,eri d accordo con quelli fin dall inizio,6,6749200000,6770000000,20800000,161,0,0
Sara Monaschi,tu mi hai venduto a quei due ma chi cazzo sei lele,6,6770800000,6803200000,32400000,162,1,0
Gabriele Marchilli,non avevo alternative,6,6804000000,6816400000,12400000,163,0,1
Gabriele Marchilli,non sai in che casino mi sono infilato,6,6817200000,6834000000,16800000,164,0,1
Sara Monaschi,mi hai usato perché hai visto l occasione giusta,6,6834800000,6859600000,24800000,165,0,0
Sara Monaschi,e adesso che sei attaccato addosso a quei due,6,6860400000,6882800000,22400000,166,0,0
Sara Monaschi,non appena trovi un occasione migliore molli pure loro,6,6887600000,6909600000,22000000,167,0,0
Sara Monaschi,tu sei una merda,6,6916000000,6938400000,22400000,168,1,0
Gabriele Marchilli,e allora sono come te,6,6916000000,6938400000,22400000,169,0,1
Gabriele Marchilli,una che usa le persone e quando non le servono più le butta via,6,6939200000,6964800000,25600000,170,0,1
Sara Monaschi,di agli amichetti tuoi che mi faccio viva io,6,7054000000,7074000000,20000000,174,0,0
Aureliano Adami,non puoi capire che roba questa ha quasi più palle di mia sorella,6,7128800000,7156400000,27600000,176,1,1
Aureliano Adami,macché,6,7175600000,7184400000,8800000,178,0,1
Aureliano Adami,questa se la batte lele,6,7185200000,7196800000,11600000,179,0,1
Aureliano Adami,se la batteva perché mi sa che mo,6,7201200000,7217200000,16000000,180,0,1
Aureliano Adami,isabel non fare la gelosa che non sei capace,6,7242000000,7260800000,18800000,182,0,1
Aureliano Adami,ce l hai una cosa pulita da darmi,6,7272800000,7288400000,15600000,183,0,1
Aureliano Adami,comunque sto cercando casa tra un po levo il disturbo,6,7338000000,7362800000,24800000,184,0,1
Aureliano Adami,di chi è sta cosa,6,7400400000,7410000000,9600000,185,0,1
Aureliano Adami,mica me l hai detto di chi è,6,7440400000,7452000000,11600000,187,0,1
Aureliano Adami,bene,6,7495200000,7520400000,25200000,190,0,1
Aureliano Adami,ciao,6,7722000000,7730400000,8400000,193,0,1
Sara Monaschi,eccoti,6,7984000000,7992400000,8400000,195,0,0
Sara Monaschi,non qui andiamo,6,8022400000,8033200000,10800000,197,0,0
Sara Monaschi,sandro il punto qua è un altro prenderci quello che vogliamo,6,8082800000,8112000000,29200000,198,0,0
Sara Monaschi,c è una soluzione,6,8124800000,8134000000,9200000,200,0,0
Sara Monaschi,dobbiamo fare entrare quei tre nella società,6,8140000000,8164400000,24400000,201,0,0
Sara Monaschi,dargli delle quote,6,8165200000,8175600000,10400000,202,0,0
Sara Monaschi,ragiona,6,8200400000,8210800000,10400000,204,0,0
Sara Monaschi,la nostra società sta per fallire,6,8234000000,8251600000,17600000,205,0,0
Sara Monaschi,se eseguiamo gli ordini di samurai quello non ci lascia nemmeno le briciole,6,8256800000,8290000000,33200000,206,0,0
Sara Monaschi,invece con loro dentro qualche possibilità ancora ce l abbiamo,6,8304000000,8332000000,28000000,207,0,0
Sara Monaschi,quelli non sanno nemmeno che cos è una società sono dei ragazzini,6,8407600000,8440400000,32800000,211,0,0
Sara Monaschi,non sarà difficile fargli fare quello che vogliamo noi,6,8446800000,8472800000,26000000,212,0,0
Sara Monaschi,ma sono proprio loro la soluzione per bloccare samurai,6,8506800000,8534800000,28000000,214,0,0
Sara Monaschi,quelli sono disposti a tutto,6,8557600000,8572800000,15200000,215,0,0
Sara Monaschi,non si fermano davanti a niente,6,8588800000,8605600000,16800000,216,0,0
Sara Monaschi,nemmeno davanti a lui,6,8613200000,8625600000,12400000,217,0,0
Sara Monaschi,cediamo delle quote ai ragazzi e li teniamo buoni,6,8671200000,8699600000,28400000,218,0,0
Sara Monaschi,poi facciamo firmare a theodosiou,6,8706800000,8726400000,19600000,219,0,0
Sara Monaschi,la cessione dei terreni alla nostra società,6,8727200000,8749200000,22000000,220,0,0
Sara Monaschi,a quel punto possiamo,6,8779200000,8790000000,10800000,221,0,0
Angelica Sale,andate a giocare,6,8905200000,8919200000,14000000,223,0,0
Angelica Sale,esco per negozi,6,9002000000,9016000000,14000000,225,0,0
Angelica Sale,devo comprare dei vestiti,6,9016800000,9046000000,29200000,227,0,0
Angelica Sale,roba carina per spadino lo faccio contento,6,9046800000,9074000000,27200000,228,0,0
Angelica Sale,no gli faccio una sorpresa,6,9096800000,9112000000,15200000,230,0,0
Angelica Sale,no li ho grazie,6,9152000000,9164400000,12400000,232,0,0
Livia Adami,niente,6,9439600000,9449200000,9600000,240,0,0
Livia Adami,il bello di casa è sempre stato aureliano,6,9463200000,9484400000,21200000,241,0,0
Livia Adami,è spiccicato a mamma,6,9504000000,9518800000,14800000,242,0,0
Livia Adami,sì,6,9591600000,9600400000,8800000,244,0,0
Livia Adami,hai sentito,6,9774000000,9785600000,11600000,250,0,0
Livia Adami,di là,6,9798000000,9813200000,15200000,252,0,0
Livia Adami,perché stai qua,6,9946000000,9955200000,9200000,253,0,0
Aureliano Adami,non lo vedi,6,9966000000,9976000000,10000000,254,0,1
Aureliano Adami,e comunque questa è casa mia,6,10016000000,10029600000,13600000,255,0,1
Aureliano Adami,che cazzo stai a fare te qua,6,10081600000,10095600000,14000000,256,1,1
Aureliano Adami,no tu,6,10105200000,10120000000,14800000,258,0,1
Aureliano Adami,ti scopi mia sorella e pensi di parlare con me,6,10120800000,10140400000,19600000,259,0,1
Aureliano Adami,faccia di merda,6,10141200000,10160800000,19600000,260,1,1
Livia Adami,per favore vai di là,6,10141200000,10160800000,19600000,261,0,0
Livia Adami,vai di là,6,10166800000,10178400000,11600000,262,0,0
Livia Adami,vai,6,10215600000,10225200000,9600000,263,0,0
Livia Adami,come stai aurelia,6,10346400000,10355600000,9200000,264,0,0
Aureliano Adami,come cazzo fai a scoparti quel parassita,6,10369600000,10391199999,21599999,265,1,1
Livia Adami,da quando ti preoccupi con chi scopo,6,10398399999,10417600000,19200001,266,0,0
Aureliano Adami,quello sta qua per i soldi nostri lo sai,6,10440000000,10457200000,17200000,267,0,1
Livia Adami,e tu perché stai qua,6,10458000000,10470000000,12000000,268,0,0
Aureliano Adami,non mi rispondi,6,10477600000,10488400000,10800000,269,0,1
Livia Adami,di che di quirino,6,10493200000,10502400000,9200000,270,0,0
Livia Adami,di che ti devo rispondere non sono cazzi tuoi,6,10503200000,10524800000,21600000,271,1,0
Livia Adami,dove stai adesso,6,10558400000,10568000000,9600000,272,0,0
Aureliano Adami,non sono cazzi tuoi,6,10584000000,10597200000,13200000,273,1,1
Livia Adami,oh,6,10613200000,10624000000,10800000,274,0,0
Livia Adami,mi dispiace che te ne sei andato,6,10651600000,10666800000,15200000,275,0,0
Aureliano Adami,non me ne sono andato,6,10682000000,10693600000,11600000,276,0,1
Aureliano Adami,m hai cacciato,6,10705200000,10715200000,10000000,277,0,1
Aureliano Adami,e ti sei messa vicino quel coglione,6,10735600000,10752800000,17200000,278,1,1
Manfredi Anacleti,mo che è morto tullio dobbiamo approfittarne,6,10830800000,10849600000,18800000,279,0,1
Manfredi Anacleti,bisogna allargarsi subito,6,10850400000,10869600000,19200000,280,0,1
Manfredi Anacleti,dobbiamo prenderci qualcosa di quei buffoni degli adami,6,10874000000,10898400000,24400000,281,0,1
Manfredi Anacleti,mo siamo in due e siamo più forti tocca farsi sentire,6,10899200000,10933200000,34000000,282,0,1
Manfredi Anacleti,dobbiamo cominciare con una cosa piccola e vedere come reagiscono,6,10962400000,10996400000,34000000,284,0,1
Manfredi Anacleti,è arrivato il momento che lo facciamo insieme però,6,10997200000,11019200000,22000000,285,0,1
Manfredi Anacleti,come una regina,6,11115200000,11129600000,14400000,288,1,1
Amedeo Cinaglia,perché se lo merita,6,11294000000,11311200000,17200000,291,0,1
Amedeo Cinaglia,dietro chi,6,11354400000,11378400000,24000000,295,0,1
Amedeo Cinaglia,samurai,6,11422000000,11432800000,10800000,297,0,1
Amedeo Cinaglia,è vietato,6,11470400000,11488400000,18000000,299,0,1
Amedeo Cinaglia,siamo in un ufficio pubblico,6,11492800000,11505200000,12400000,300,0,1
Amedeo Cinaglia,no io lavoro con uno che a roma fa affari con tutti,6,11555600000,11577600000,22000000,302,0,1
Amedeo Cinaglia,compresi voi,6,11586000000,11595200000,9200000,303,0,1
Amedeo Cinaglia,e tu perché sei qui,6,11624400000,11643600000,19200000,304,0,1
Amedeo Cinaglia,mi è sempre piaciuto stefano,6,11703200000,11718000000,14800000,308,0,1
Amedeo Cinaglia,il più bravo politico della sua generazione,6,11722400000,11741600000,19200000,309,0,1
Amedeo Cinaglia,il più preparato il più intelligente il più lucido,6,11746800000,11777200000,30400000,310,0,1
Amedeo Cinaglia,il migliore di tutti noi,6,11788000000,11801200000,13200000,311,0,1
Amedeo Cinaglia,senza dubbio,6,11804800000,11814000000,9200000,312,0,1
Amedeo Cinaglia,hai scelto un uomo corrotto gabriella,6,11865200000,11887200000,22000000,314,0,1
Amedeo Cinaglia,dimmi che non lo sapevi,6,11913200000,11925200000,12000000,315,0,1
Sara Monaschi,allora farò in modo che il vaticano venda i terreni alla società di mio marito,6,12097600000,12135200000,37600000,317,0,0
Sara Monaschi,e a voi vi cedo delle quote,6,12136000000,12150400000,14400000,318,0,0
Aureliano Adami,che vuol dire,6,12161600000,12171600000,10000000,319,0,1
Sara Monaschi,vuol dire che diventiamo soci,6,12178400000,12193600000,15200000,320,0,0
Alberto Anacleti,soci,6,12205600000,12214000000,8400000,321,0,1
Sara Monaschi,è l unica soluzione il vaticano non venderà mai a voi da soli,6,12214800000,12250400000,35600000,322,0,0
Alberto Anacleti,che quote quanto,6,12256400000,12273600000,17200000,323,0,1
Sara Monaschi,cinquanta percento,6,12278000000,12292400000,14400000,324,0,0
Alberto Anacleti,facciamo il 60 siamo in tre,6,12314400000,12334800000,20400000,325,0,1
Alberto Anacleti,si divide meglio no,6,12352800000,12364400000,11600000,326,0,1
Sara Monaschi,va bene,6,12391600000,12400800000,9200000,327,0,0
Aureliano Adami,dai va avanti forza,6,12411600000,12424000000,12400000,328,0,1
Sara Monaschi,quei terreni li vuole anche samurai,6,12436400000,12452000000,15600000,329,0,0
Alberto Anacleti,parla chiaro però che vuoi dire,6,12465200000,12484000000,18800000,330,0,1
Aureliano Adami,te non dici un cazzo gabrie,6,12495600000,12510400000,14800000,331,1,1
Gabriele Marchilli,che devo dire,6,12526400000,12535600000,9200000,332,0,1
Aureliano Adami,ma tu hai capito questa che vuole,6,12536400000,12551200000,14800000,333,0,1
Gabriele Marchilli,vuole fare la società con noi,6,12552000000,12574800000,22800000,334,0,1
Aureliano Adami,sì col cazzo,6,12552000000,12574800000,22800000,335,1,1
Aureliano Adami,questa vuole che ammazziamo samurai,6,12588800000,12605200000,16400000,336,0,1
Aureliano Adami,vero,6,12611600000,12620400000,8800000,337,0,1
Sara Monaschi,voglio essere sicura che,6,12662000000,12678000000,16000000,338,0,0
Sara Monaschi,fare società con voi sia la scelta migliore,6,12685200000,12706800000,21600000,339,0,0
Aureliano Adami,mmh,6,12707600000,12716000000,8400000,340,0,1
Aureliano Adami,vuoi ammazzare uno e ti vergogni di dirlo,6,12726000000,12745600000,19600000,341,0,1
Sara Monaschi,allora lasciamo perdere,6,12773200000,12786400001,13200001,342,0,0
Sara Monaschi,sputtanate il monsignore e l affare non lo fa nessuno,6,12787200000,12808800001,21600001,343,0,0
Aureliano Adami,no l affare si fa altro che non si fa,6,12809600000,12830000000,20400000,344,0,1
Aureliano Adami,però le regole le facciamo noi,6,12839600000,12851600000,12000000,345,0,1
Aureliano Adami,ci dai il 75,6,12859600000,12876400000,16800000,346,0,1
Sara Monaschi,non si può fare,6,12887200000,12910400000,23200000,347,0,0
Aureliano Adami,ma io non te lo sto a chiedere,6,12887200000,12910400000,23200000,348,0,1
Aureliano Adami,o è così o niente,6,12924800000,12936000000,11200000,349,0,1
Sara Monaschi,va bene,6,13006800000,13018800001,12000001,350,0,0
Aureliano Adami,brava,6,13006800000,13018800001,12000001,351,0,1
Aureliano Adami,mo dimmi dove sta il prete,6,13024000000,13046800000,22800000,352,0,1
Sara Monaschi,perché,6,13024000000,13046800000,22800000,353,0,0
Aureliano Adami,ti dovesse venire in mente qualche strana idea,6,13047600000,13069200000,21600000,354,0,1
Aureliano Adami,tipo di venderci a samurai,6,13082400000,13097200000,14800000,355,0,1
Aureliano Adami,invece lele viene con te a firmare le carte,6,13115600000,13136000000,20400000,356,0,1
Aureliano Adami,e io e lo zingaro andiamo a prendere il prete,6,13138800000,13158000000,19200000,357,0,1
Aureliano Adami,dimmi dove sta,6,13168400000,13179200000,10800000,358,0,1
Sara Monaschi,sta in ritiro,6,13207200000,13218400000,11200000,359,0,0
Sara Monaschi,in un abbazia fuori roma,6,13228400000,13242400000,14000000,360,0,0
Aureliano Adami,oh che è,6,13446000000,13458400000,12400000,367,0,1
Aureliano Adami,andiamo a sbattere stai fermo,6,13587600000,13604000000,16400000,371,1,1
Aureliano Adami,leva,6,13658000000,13672800000,14800000,373,0,1
Alberto Anacleti,l abbazia chiude alle nove,6,13907200000,13919600000,12400000,375,0,1
Alberto Anacleti,dentro ci vivono sei frati e dormono tutti là al secondo piano,6,13930000000,13962800000,32800000,376,0,1
Aureliano Adami,come cazzo hai fatto a saperlo,6,13987600000,14003200000,15600000,377,1,1
Alberto Anacleti,basta sapere a chi domandare,6,14018400000,14032400000,14000000,378,0,1
Aureliano Adami,mortacci vostri state dappertutto,6,14066400000,14082400000,16000000,379,0,1
Alberto Anacleti,hai capito sì,6,14083200000,14097200000,14000000,380,0,1
Aureliano Adami,abbiamo un po di tempo andiamo ti faccio vedere una cosa,6,14113600000,14140800000,27200000,381,0,1
Manfredi Anacleti,hai fatto spese,6,14255200000,14267200000,12000000,383,0,1
Angelica Sale,ho fatto come m hai detto,6,14270400000,14284000000,13600000,384,0,0
Manfredi Anacleti,cos è,6,14337600000,14362800000,25200000,385,0,1
Angelica Sale,il resto dei soldi che mi hai dato,6,14337600000,14362800000,25200000,386,0,0
Manfredi Anacleti,ma no questi li puoi tenere e magari ti ci fai un altro regaletto,6,14368000000,14396800000,28800000,387,0,1
Manfredi Anacleti,mo vatti a vestire vatti a fare bella per spadino,6,14440400000,14465200000,24800000,388,0,1
Manfredi Anacleti,allora,6,14507200000,14515600000,8400000,389,0,1
Manfredi Anacleti,chiama vincenzo fatti mandare due ragazzi,6,14583200000,14606800000,23600000,393,0,1
Manfredi Anacleti,questa cosa si fa insieme,6,14621600000,14636800000,15200000,394,0,1
Manfredi Anacleti,subito non c è motivo di aspettare,6,14653200000,14674000000,20800000,396,0,1
Manfredi Anacleti,l eur mi piace l eur,6,14674800000,14696000000,21200000,397,0,1
Alberto Anacleti,ammazza ma che è sta puzza,6,14841600000,14857600000,16000000,399,0,1
Aureliano Adami,andiamo vieni con me,6,14870000000,14881600000,11600000,400,0,1
Alberto Anacleti,ma che è sto posto,6,14982000000,14993600000,11600000,401,0,1
Aureliano Adami,facciamoci un bagno,6,15062000000,15074400000,12400000,402,0,1
Alberto Anacleti,che,6,15078800000,15087200000,8400000,403,0,1
Alberto Anacleti,dentro a sta merda,6,15090800000,15100800000,10000000,404,1,1
Alberto Anacleti,ma che hai cominciato a drogarti,6,15105600000,15123600000,18000000,405,0,1
Aureliano Adami,spogliati,6,15134800000,15144400000,9600000,406,0,1
Alberto Anacleti,no,6,15157200000,15165600000,8400000,407,0,1
Alberto Anacleti,non ci penso proprio io c ho freddo,6,15177200000,15202000000,24800000,408,0,1
Aureliano Adami,e spogliati,6,15177200000,15202000000,24800000,409,0,1
Alberto Anacleti,ma che sei matto,6,15243600000,15254000000,10400000,410,0,1
Aureliano Adami,fa come cazzo ti pare allora,6,15266800000,15283600000,16800000,411,1,1
Aureliano Adami,non sai che ti perdi,6,15361600000,15372400000,10800000,412,0,1
Alberto Anacleti,ah,6,15378400000,15388000000,9600000,413,0,1
Aureliano Adami,che fai rimani lì,6,15656400001,15666400001,10000000,414,0,1
Aureliano Adami,cioè questa è una zoccola,6,16580400000,16594800000,14400000,433,1,1
Aureliano Adami,ma che cazzo vuole dalla vita mia,6,16603200000,16617600000,14400000,434,1,1
Alberto Anacleti,ma ti piace,6,16635600000,16644800000,9200000,435,0,1
Aureliano Adami,ma che c entra,6,16649600000,16658000000,8400000,436,0,1
Alberto Anacleti,ci stai bene insieme,6,16676800000,16691600000,14800000,437,0,1
Aureliano Adami,e insisti,6,16676800000,16691600000,14800000,438,0,1
Alberto Anacleti,ci stai bene sì o no,6,16715600000,16726400000,10800000,439,0,1
Aureliano Adami,sì mi fa stare bene,6,16756400000,16770400000,14000000,440,0,1
Aureliano Adami,però sempre zoccola è,6,16790400000,16804400000,14000000,441,1,1
Aureliano Adami,pure negra,6,16808400000,16817600000,9200000,442,1,1
Alberto Anacleti,mo ho capito il problema non è che è zoccola è che è negra,6,16838000000,16862000000,24000000,443,1,1
Aureliano Adami,vabbè lascia stare,6,16866400001,16878800001,12400000,444,0,1
Aureliano Adami,te invece con la sposina come va,6,16902000000,16920800000,18800000,445,0,1
Alberto Anacleti,tutto a posto,6,16954000000,16963200000,9200000,446,0,1
Aureliano Adami,non ti piace eh,6,17001200000,17009600000,8400000,447,0,1
Aureliano Adami,e mo,6,17028000000,17036800000,8800000,448,0,1
Aureliano Adami,come cazzo fai quella la devi tenere per tutta la vita,6,17050000000,17073200000,23200000,449,1,1
Aureliano Adami,fine pena mai,6,17079200000,17089200000,10000000,450,0,1
Alberto Anacleti,ma che cazzo stai a fare,6,17093200000,17119200000,26000000,451,1,1
Aureliano Adami,questa fa bene alla pelle,6,17093200000,17119200000,26000000,452,0,1
Aureliano Adami,tieni,6,17120000000,17141200000,21200000,453,0,1
Alberto Anacleti,ma che cazzo stai a fare,6,17120000000,17141200000,21200000,454,1,1
Aureliano Adami,fa come te pare,6,17148400000,17158800000,10400000,455,0,1
Aureliano Adami,anzi mettimela sulla schiena che non ci arrivo,6,17254400000,17275200000,20800000,456,0,1
Alberto Anacleti,che,6,17276000000,17294800000,18800000,457,0,1
Aureliano Adami,e mettimi sta cosa,6,17276000000,17294800000,18800000,458,0,1
Aureliano Adami,guarda dove ti ho portato ma quando l hai mai visto un posto così,6,17303200000,17334000000,30800000,459,0,1
Alberto Anacleti,ecco l ho messo,6,17436800000,17447200000,10400000,460,0,1
Aureliano Adami,grazie,6,17448000000,17456400000,8400000,461,0,1
Aureliano Adami,girati che te la metto,6,17460800000,17479200000,18400000,462,0,1
Alberto Anacleti,non mi serve,6,17460800000,17479200000,18400000,463,0,1
Aureliano Adami,dai,6,17480000000,17488800000,8800000,464,0,1
Aureliano Adami,tieni lo sai che pelle ti viene,6,17495200000,17516400000,21200000,465,0,1
Aureliano Adami,guarda che roba,6,17517200000,17526800000,9600000,466,0,1
Alberto Anacleti,dai che dobbiamo andare a prendere il prete,6,17590400000,17609600000,19200000,467,0,1
Aureliano Adami,ora ci andiamo dieci minuti rilassati,6,17610400000,17627600000,17200000,468,0,1
Sara Monaschi,sbrighiamoci il notaio mi ha già fatto un favore a riceverci a quest ora,6,17838400000,17870800000,32400000,469,0,0
Aureliano Adami,andiamo,6,17931600000,17941200000,9600000,470,0,1
Aureliano Adami,che camera è,6,18435600000,18446000000,10400000,471,0,1
Alberto Anacleti,e che cazzo ne so,6,18451200000,18464400000,13200000,472,1,1
Alberto Anacleti,ti ricorda qualcosa,6,19323200000,19341600000,18400000,477,0,1
Aureliano Adami,mmh,6,19323200000,19341600000,18400000,478,0,1
Aureliano Adami,dove cazzo sta questo,6,19363600000,19376400000,12800000,479,1,1
Alberto Anacleti,vuoi vedere che sta pregando,6,19400000000,19413600000,13600000,480,0,1
Aureliano Adami,zio prete,6,20382000000,20394000000,12000000,484,0,1
Aureliano Adami,dove cazzo vai vieni qua che non succede niente,6,20402400000,20430000000,27600000,485,1,1
Alberto Anacleti,zio prete uh,6,20430800000,20450400000,19600000,486,0,1
Aureliano Adami,ma che cazzo fai ti chiudi dentro zio prete eh,6,20646000000,20674000000,28000000,489,1,1
Aureliano Adami,apri sta porta,6,20691999999,20701999999,10000000,491,0,1
Aureliano Adami,apri sta cazzo di porta e non mi fare strillare,6,20715200000,20738800000,23600000,492,1,1
Aureliano Adami,che se si svegliano i fraticelli gli devo spiegare un sacco di cose poi,6,20739600000,20769600000,30000000,493,0,1
Aureliano Adami,invece tu mi apri la porta e non succede niente dai,6,20772399999,20795600000,23200001,494,0,1
Alberto Anacleti,amico mio ci ha mandato sara hai capito chi,6,20811999999,20841999999,30000000,496,0,1
Alberto Anacleti,sara l amica tua ci ha detto di venirti a prendere,6,20852399999,20874400000,22000001,498,0,1
Alberto Anacleti,quindi fai il bravo apri sta cazzo di porta,6,20875200000,20896000000,20800000,499,1,1
Aureliano Adami,dai,6,20896799999,20905200000,8400001,500,0,1
Gabriele Marchilli,sì,6,21100400000,21108800000,8400000,503,0,1
Gabriele Marchilli,sì ho capito,6,21168000000,21180800000,12800000,504,0,1
Gabriele Marchilli,arriviamo subito,6,21189200000,21200400000,11200000,505,0,1
Manfredi Anacleti,bene,6,21794800000,21804400000,9600000,520,0,1
Manfredi Anacleti,vediamo come reagisce quella stronza di ostia,6,21810400000,21835200000,24800000,521,1,1
Manfredi Anacleti,oh stiamo in campana,6,21846800000,21863200000,16400000,522,0,1
Manfredi Anacleti,non vai a dormire,6,22466000000,22477200000,11200000,523,0,1
Manfredi Anacleti,non so di che parli,6,22521600000,22533600000,12000000,525,0,1
Manfredi Anacleti,va a dormire che è tardi,6,22601200000,22616000000,14800000,527,0,1
Samurai Valerio,che c è,6,22798800000,22809600000,10800000,529,0,1
Aureliano Adami,dai oh,6,22994800000,23014000000,19200000,532,0,1
Alberto Anacleti,un attimo,6,22994800000,23014000000,19200000,533,0,1
Alberto Anacleti,ci ho messo mezz ora per trovare la cucina pare un labirinto sto posto,6,23021600000,23053200000,31600000,534,0,1
Alberto Anacleti,tie,6,23057200000,23066800000,9600000,535,0,1
Alberto Anacleti,senti che ti mangi,6,23070400000,23082800000,12400000,536,0,1
Alberto Anacleti,l ho fatta con niente,6,23086000000,23104000000,18000000,537,0,1
Aureliano Adami,ma che è,6,23086000000,23104000000,18000000,538,0,1
Alberto Anacleti,aglio olio e peperoncino,6,23110400000,23124000000,13600000,539,0,1
Aureliano Adami,mortacci quanto pizzica spadi,6,23196400000,23215600000,19200000,540,0,1
Alberto Anacleti,oh,6,23228400000,23236800000,8400000,541,0,1
Alberto Anacleti,ai preti si sa piace piccante,6,23240000000,23258800000,18800000,542,0,1
Alberto Anacleti,chiedi a isabel che magari te lo spiega,6,23266400000,23289600000,23200000,543,0,1
Aureliano Adami,eccoli,6,23311600000,23321200000,9600000,545,0,1
Aureliano Adami,sono arrivati,6,23361200000,23370800000,9600000,546,0,1
Alberto Anacleti,li vado a prendere,6,23371600000,23382000000,10400000,547,0,1
Aureliano Adami,comunque quella è la donna mia non ti permettere,6,23386400000,23408000000,21600000,548,0,1
Aureliano Adami,cammina va,6,23419200000,23428800000,9600000,549,0,1
Amedeo Cinaglia,stefano forsini lo conosci,6,23472800000,23488800000,16000000,550,0,1
Samurai Valerio,perché vuoi saperlo,6,23504400000,23515200000,10800000,551,0,1
Amedeo Cinaglia,è un parlamentare,6,23518800000,23530400000,11600000,552,0,1
Amedeo Cinaglia,è stato sottosegretario alla cultura,6,23538000000,23568000000,30000000,553,0,1
Samurai Valerio,sì lo so chi è,6,23538000000,23568000000,30000000,554,0,1
Samurai Valerio,so anche che è il marito della tua ex,6,23574800000,23593600000,18800000,555,0,1
Samurai Valerio,perché vuoi sapere se lo conosco,6,23601200000,23615600000,14400000,556,0,1
Amedeo Cinaglia,anni fa giravano voci su delle mazzette per far approvare il piano eolico,6,23629200000,23662000000,32800000,557,0,1
Amedeo Cinaglia,lui era coinvolto ma io non ho le prove,6,23674400000,23692800000,18400000,558,0,1
Amedeo Cinaglia,forsini mi serve per arrivare a taccon ma non vuole aiutarmi,6,23728000000,23757600000,29600000,559,0,1
Samurai Valerio,vuoi ricattare un parlamentare della repubblica italiana,6,23788000000,23813600000,25600000,560,0,1
Amedeo Cinaglia,mi serve per mettere pressione,6,23832400000,23858000000,25600000,561,0,1
Samurai Valerio,ho capito a che serve,6,23832400000,23858000000,25600000,562,0,1
Amedeo Cinaglia,mi puoi aiutare o no,6,23876800000,23887200000,10400000,563,0,1
Samurai Valerio,ci stai prendendo gusto eh,6,23905200000,23920400000,15200000,564,0,1
Samurai Valerio,vedo se trovo qualcosa su di lui mi faccio sentire io,6,23958400000,23985600000,27200000,565,0,1
Sara Monaschi,dove sta,6,24167600000,24176000000,8400000,566,0,0
Sara Monaschi,monsignore sono qui,6,24205600000,24218400000,12800000,567,0,0
Sara Monaschi,dai andate,6,24343200000,24352000000,8800000,570,0,0
Aureliano Adami,vedi di sbrigarti,6,24412000000,24424800000,12800000,571,0,1
Sara Monaschi,sono sola,6,24501200000,24511200000,10000000,572,0,0
Alberto Anacleti,ecco mo vediamo l amica tua che s inventa,6,24776000000,24801600000,25600000,574,0,1
Gabriele Marchilli,risolverà tutto,6,24814000000,24823600000,9600000,575,0,1
Gabriele Marchilli,e non è la prima volta,6,24828400000,24842000000,13600000,576,0,1
Aureliano Adami,veramente le cose nostre ce le siamo sempre risolte da soli quindi stai zitto,6,24842800000,24880000000,37200000,577,0,1
Alberto Anacleti,lascialo perdere aurelia non lo vedi che si è innamorato,6,24880800000,24914400000,33600000,578,0,1
Aureliano Adami,ti sei innamorato lele,6,24917600000,24928800000,11200000,579,0,1
Aureliano Adami,e sposati il prete ci sta la chiesa pure,6,24934000000,24958000000,24000000,580,0,1
Aureliano Adami,ci sta spadino che ti fa da testimone,6,24958800000,24975600000,16800000,581,0,1
Aureliano Adami,e sai che bel matrimonio di merda che ti esce fuori,6,24976400000,24999600000,23200000,582,1,1
Alberto Anacleti,certo,6,25000400000,25009200000,8800000,583,0,1
Alberto Anacleti,potrebbe essere tua madre,6,25015200000,25032400000,17200000,584,0,1
Gabriele Marchilli,non ti stanchi mai di dire cazzate te,6,25040400000,25056800000,16400000,585,1,1
Aureliano Adami,ma che cazzo sta a fare,6,25129200000,25140400000,11200000,587,1,1
Sara Monaschi,puoi tornare a casa tua in grecia,6,25285200000,25304000000,18800000,588,0,0
Sara Monaschi,dammi la mano,6,25318000000,25327600000,9600000,589,0,0
Sara Monaschi,dai,6,25355200000,25363600000,8400000,590,0,0
Sara Monaschi,dammi la mano,6,25366800000,25377200000,10400000,591,0,0
Sara Monaschi,no,6,25493600000,25502000000,8400000,595,0,0
Aureliano Adami,ma che cazzo ha fatto questo,6,25678000000,25696400000,18400000,596,1,1
Contessa Sveva Della Rocca Croce,buonasera,7,832400000,846000000,13600000,1,0,0
Contessa Sveva Della Rocca Croce,ciao,7,1150000000,1158400000,8400000,3,0,0
Alberto Anacleti,ti pare che quello si doveva buttare,7,1452000000,1469600000,17600000,4,0,1
Sara Monaschi,dobbiamo ringraziare voi bravi,7,1478800000,1494000000,15200000,5,0,0
Alberto Anacleti,non è il momento delle prediche questo eh,7,1494800000,1515600000,20800000,6,0,1
Sara Monaschi,sì giusto,7,1516400000,1525600000,9200000,7,0,0
Sara Monaschi,non abbiamo più niente da dirci mi pare no,7,1526400000,1546400000,20000000,8,0,0
Sara Monaschi,lele portami a casa,7,1552000000,1574000000,22000000,9,0,0
Aureliano Adami,dove cazzo vai vieni qua,7,1552000000,1574000000,22000000,10,1,1
Sara Monaschi,ma che vuoi ancora scusa,7,1591200000,1604800000,13600000,11,0,0
Sara Monaschi,non hai capito che è tutto finito,7,1605600000,1623600000,18000000,12,0,0
Sara Monaschi,theodosiou è morto,7,1624400000,1639200000,14800000,13,0,0
Aureliano Adami,ho capito,7,1624400000,1639200000,14800000,14,0,1
Sara Monaschi,l avete ammazzato voi,7,1640000000,1654000000,14000000,15,0,0
Sara Monaschi,per te sarà una cosa normale ma per me no,7,1654800000,1675200000,20400000,16,0,0
Aureliano Adami,ho capito però mo c è un problema lo devi risolvere te,7,1676000000,1699600000,23600000,17,0,1
Sara Monaschi,certo e come,7,1700400000,1715600000,15200000,18,0,0
Aureliano Adami,ma che cazzo ne so tu hai gli amici in vaticano,7,1716400000,1742000000,25600000,19,1,1
Aureliano Adami,inventati qualcosa dai,7,1742800000,1758800000,16000000,20,0,1
Sara Monaschi,non invento proprio niente,7,1761200000,1774000000,12800000,21,0,0
Sara Monaschi,da oggi ognuno per la sua strada,7,1774800000,1790000000,15200000,22,0,0
Alberto Anacleti,non è una festa da cui te ne puoi andare quando ti pare,7,1790800000,1814000000,23200000,23,0,1
Aureliano Adami,sistema sta cosa o ti faccio fare la fine del prete,7,1814800000,1844000000,29200000,24,0,1
Gabriele Marchilli,andiamo,7,1848800000,1860000000,11200000,25,0,1
Aureliano Adami,va,7,1860800000,1869200000,8400000,26,0,1
Alberto Anacleti,andiamocene pure noi,7,1943200000,1956800000,13600000,27,0,1
Sara Monaschi,non è ancora finita quelli vogliono andare avanti,7,2035200000,2060400000,25200000,28,0,0
Sara Monaschi,ma che c entro io con loro eh,7,2061200000,2077600000,16400000,29,0,0
Sara Monaschi,che c entro me lo dici,7,2080800000,2104000000,23200000,30,0,0
Gabriele Marchilli,quindi tu sei quella pulita,7,2080800000,2104000000,23200000,31,0,1
Gabriele Marchilli,non eri tu che organizzavi i festini per il prete,7,2113200000,2134000000,20800000,32,0,1
Gabriele Marchilli,che traffichi per i terreni del vaticano,7,2134800000,2154400000,19600000,33,0,1
Gabriele Marchilli,quello che vogliono loro lo vogliamo tutti,7,2162400000,2186800000,24400000,34,0,1
Gabriele Marchilli,allora è giusto che stiamo tutti insieme,7,2187600000,2207200000,19600000,35,0,1
Gabriele Marchilli,ecco che c entri,7,2214800000,2226000000,11200000,36,0,1
Gabriele Marchilli,oggi ti saresti fermata davvero,7,2283600000,2302400000,18800000,37,0,1
Gabriele Marchilli,magari saresti andata avanti da sola,7,2317200000,2334400000,17200000,38,0,1
Gabriele Marchilli,pensavi di fregarli,7,2375600000,2391200000,15600000,39,0,1
Gabriele Marchilli,non è così,7,2402000000,2411600000,9600000,40,0,1
Gabriele Marchilli,ormai stiamo tutti insieme,7,2424400000,2438400000,14000000,41,0,1
Gabriele Marchilli,e io sono l unico in grado di proteggerti,7,2444400000,2465200000,20800000,42,0,1
Gabriele Marchilli,l unico che ti vuole bene,7,2478400000,2490000000,11600000,43,0,1
Sara Monaschi,ok,7,2566400000,2575600000,9200000,44,0,0
Sara Monaschi,senti portami all attico non posso presentarmi a casa a quest ora,7,2639200000,2672000000,32800000,45,0,0
Sara Monaschi,poi ti chiamo io,7,2702800000,2714000000,11200000,46,0,0
Alberto Anacleti,e levati,7,3228800000,3238800000,10000000,47,0,1
Angelica Sale,non ti piaccio spadi,7,3329200000,3341200000,12000000,48,0,0
Angelica Sale,me lo puoi dire non mi offendo piaccio a un sacco di gente,7,3351600001,3375200000,23599999,49,0,0
Angelica Sale,se non la fai con me la parte tua almeno in famiglia la devi fare,7,3450400000,3478000000,27600000,50,0,0
Alberto Anacleti,so io quello che devo fare in famiglia,7,3489200000,3507600000,18400000,51,0,1
Angelica Sale,e non mi pare,7,3513200000,3524400000,11200000,52,0,0
Angelica Sale,ti fai parlare dietro spadi,7,3525200000,3541200000,16000000,53,0,0
Angelica Sale,e io non voglio scoprire d essermi sposata con un pupazzo,7,3545600000,3571600000,26000000,54,0,0
Alberto Anacleti,hai sposato un uomo,7,3575600000,3588400000,12800000,55,0,1
Alberto Anacleti,e gli devi portare rispetto chiaro,7,3592400000,3612000000,19600000,56,0,1
Alberto Anacleti,e mo mettiti a dormire,7,3617200000,3630400000,13200000,57,0,1
Aureliano Adami,ahó,7,3882000000,3890400000,8400000,60,0,1
Aureliano Adami,mi stai cacciando,7,4002000000,4014800000,12800000,62,0,1
Aureliano Adami,veramente ero venuto per parlare,7,4065600000,4082400000,16800000,65,0,1
Aureliano Adami,per dirti che per certe cose ci vuole tempo,7,4147200000,4165200000,18000000,67,0,1
Aureliano Adami,e io mo il tempo non ce l ho,7,4176800000,4190400000,13600000,68,0,1
Aureliano Adami,va bene ciao,7,4254800000,4268400000,13600000,70,0,1
Manfredi Anacleti,tu stamattina mi servi,7,5824400000,5838000000,13600000,96,0,1
Manfredi Anacleti,prendi due ragazzi e te ne vai al bar dell eur,7,5840000000,5862400000,22400000,97,0,1
Manfredi Anacleti,non vorrei che sti adami pensassero che stiamo giocando,7,5866400000,5898000000,31600000,98,0,1
Manfredi Anacleti,certo lì ormai è zona nostra,7,5921600000,5941600000,20000000,100,0,1
Manfredi Anacleti,va,7,5942400000,5951600000,9200000,101,0,1
Amedeo Cinaglia,posso,7,6104400000,6113600000,9200000,108,0,1
Samurai Valerio,tu hai un conto personale in sospeso con questo forsini vero,7,6220000000,6255600000,35600000,109,0,1
Amedeo Cinaglia,e allora,7,6267200000,6276000000,8800000,110,0,1
Amedeo Cinaglia,che c entra,7,6285200000,6294400000,9200000,111,0,1
Samurai Valerio,magari si scopava tua moglie da prima,7,6298800000,6318000000,19200000,112,0,1
Samurai Valerio,magari ti vuoi vendicare,7,6336000000,6350000000,14000000,113,0,1
Samurai Valerio,magari stai facendo questa cosa per i tuoi interessi,7,6380000000,6405600000,25600000,114,0,1
Amedeo Cinaglia,magari adesso mando tutto per aria e sto gioco te lo giochi da solo,7,6406400000,6437600000,31200000,115,0,1
Samurai Valerio,toh,7,6509600000,6518000000,8400000,116,0,1
Samurai Valerio,vedi se con questi ti torna la memoria,7,6527600000,6548800000,21200000,117,0,1
Livia Adami,perché lo sanno che rispetto a noi non sono niente,7,6776800000,6800800000,24000000,120,0,0
Livia Adami,adesso che non c è più mio padre vogliono capire che sono in grado di fare,7,6839200000,6872400000,33200000,122,0,0
Livia Adami,ste merde,7,6876000000,6886000000,10000000,123,1,0
Livia Adami,devo sapere che succede all eur buttaci un occhio,7,6896000000,6920000000,24000000,124,0,0
Aureliano Adami,ciao romole,7,6961600000,6971200000,9600000,125,0,1
Aureliano Adami,li vieni con me dobbiamo parlare,7,6976400000,6993200000,16800000,126,0,1
Contessa Sveva Della Rocca Croce,sei riuscita solo a rallentare la votazione,7,7041600000,7070000000,28400000,127,0,0
Sara Monaschi,non potevo fare altro,7,7070800000,7083600000,12800000,128,0,0
Contessa Sveva Della Rocca Croce,va bene ma la prossima volta devono votare per te,7,7094400000,7121600000,27200000,129,0,0
Contessa Sveva Della Rocca Croce,quando si riunisce di nuovo la commissione,7,7135200000,7158400000,23200000,130,0,0
Sara Monaschi,è questo il punto non lo so,7,7159200000,7181200000,22000000,131,0,0
Sara Monaschi,hanno paura che si scopra qualcosa di brutto su theodosiou,7,7211600000,7238000000,26400000,132,0,0
Sara Monaschi,e che lo scandalo travolga anche loro,7,7238800000,7257200000,18400000,133,0,0
Contessa Sveva Della Rocca Croce,allora fa in modo che non ci sia nessuno scandalo,7,7270000000,7292800000,22800000,134,0,0
Contessa Sveva Della Rocca Croce,voteranno,7,7306800000,7315600000,8800000,135,0,0
Contessa Sveva Della Rocca Croce,e ti saranno grati,7,7320800000,7331600000,10800000,136,0,0
Sara Monaschi,lei può aiutarmi,7,7352000000,7362400000,10400000,137,0,0
Contessa Sveva Della Rocca Croce,posso cercare di sapere il nome del medico che esegue l autopsia,7,7382000000,7420400000,38400000,138,0,0
Contessa Sveva Della Rocca Croce,ma il resto devi farlo tu,7,7432000000,7444400000,12400000,139,0,0
Sara Monaschi,e come,7,7465200000,7474000000,8800000,140,0,0
Contessa Sveva Della Rocca Croce,sara,7,7482400000,7490800000,8400000,141,0,0
Contessa Sveva Della Rocca Croce,sei in società con dei criminali in queste cose sei più esperta di me,7,7498400000,7535600000,37200000,142,0,0
Livia Adami,allora,7,7624800000,7634800000,10000000,144,0,0
Aureliano Adami,che vuoi fare con sti zingari,7,7647600000,7662000000,14400000,145,0,1
Livia Adami,ci devo pensare,7,7675200000,7686400000,11200000,146,0,0
Aureliano Adami,a forza di pensarci ti sono entrati dentro casa,7,7687200000,7707600000,20400000,147,0,1
Livia Adami,non è così,7,7708400000,7719200000,10800000,148,0,0
Livia Adami,lascia stare,7,7730400000,7740400000,10000000,149,0,0
Aureliano Adami,tanto questi non sono più affari miei,7,7753600000,7770400000,16800000,150,0,1
Livia Adami,non sono affari tuoi,7,7775200000,7786400000,11200000,151,0,0
Aureliano Adami,no sei te che comandi,7,7787200000,7802000000,14800000,152,0,1
Aureliano Adami,mo vediamo come va a finire,7,7812800000,7825600000,12800000,153,0,1
Livia Adami,ecco,7,7840400000,7848800000,8400000,154,0,0
Livia Adami,bravo,7,7860800000,7869200000,8400000,155,0,0
Livia Adami,facciamo vedere a tutti che siamo divisi,7,7878400000,7898400000,20000000,156,0,0
Livia Adami,perché credi che manfredi ci è venuto addosso,7,7914400000,7936400000,22000000,157,0,0
Aureliano Adami,perché a ostia comanda una femmina livia,7,7937200000,7958400000,21200000,158,0,1
Aureliano Adami,una a cui hanno ammazzato il padre e non ha fatto una pippa,7,7978800000,8002800000,24000000,159,1,1
Livia Adami,che ci sei venuto a fare qua,7,8053200000,8066400000,13200000,160,0,0
Aureliano Adami,a dirti che senza la firma mia i terreni di ostia samurai li prende col cazzo,7,8088400000,8126000000,37600000,161,1,1
Aureliano Adami,e mi prendo casa di mamma,7,8145200000,8158400000,13200000,162,0,1
Amedeo Cinaglia,stefano,7,9248800000,9257200000,8400000,166,0,1
Amedeo Cinaglia,mi dovevi una risposta e invece non mi hai fatto sapere niente,7,9274800000,9305200000,30400000,168,0,1
Amedeo Cinaglia,che sei un corrotto e una merda io penso che l abbia capito,7,9616800000,9646400000,29600000,173,1,1
Amedeo Cinaglia,ci prendiamo un caffè o parliamo qua del nostro amico taccon,7,9687600000,9721600000,34000000,174,0,1
Amedeo Cinaglia,e di quella nomina ai musei di roma,7,9722400000,9739600000,17200000,175,0,1
Sara Monaschi,grazie anna,7,9795200000,9804400000,9200000,177,0,0
Sara Monaschi,loro vogliono che la chiesa esca pulita da quello che è successo a theodosiou,7,9930000000,9961600000,31600000,181,0,0
Sara Monaschi,e io farò in modo di aiutarli,7,9962400000,9977200000,14800000,182,0,0
Sara Monaschi,certo in cambio dovranno darmi qualcosa,7,9980400000,9998400000,18000000,183,0,0
Sara Monaschi,mi sono consigliata,7,10032000000,10044400000,12400000,185,0,0
Sara Monaschi,hai sempre lasciato il gioco sporco a me sandro ma i vantaggi ce li siamo divisi,7,10170400000,10206800000,36400000,190,0,0
Sara Monaschi,troppo comodo,7,10207600000,10216000000,8400000,191,0,0
Sara Monaschi,va bene,7,10289200000,10297600000,8400000,193,0,0
Sara Monaschi,chiudiamola qua,7,10301600000,10310799999,9199999,194,0,0
Sara Monaschi,io mi fermo,7,10318800000,10327200000,8400000,195,0,0
Sara Monaschi,decidi tu cosa fare,7,10340799999,10354000000,13200001,196,0,0
Samurai Valerio,che altro c è,7,10711200000,10720400000,9200000,203,0,1
Samurai Valerio,tu mi dovevi portare già le carte firmate livia,7,10745200000,10767600000,22400000,204,0,1
Livia Adami,gli zingari stanno alzando la testa a casa mia,7,10771200000,10793200000,22000000,205,0,0
Livia Adami,pensano di essere uguali a noi,7,10797600000,10812400000,14800000,206,0,0
Livia Adami,vogliono il posto nostro e questo non può essere,7,10813200000,10834800000,21600000,207,0,0
Samurai Valerio,lascia perdere gli zingari non si permetteranno più,7,10835600000,10866000000,30400000,208,0,1
Samurai Valerio,tu pensa solo a chiudere con quei terreni,7,10866800000,10885200000,18400000,209,0,1
Samurai Valerio,capito solo a quello,7,10886000000,10900400000,14400000,210,0,1
Livia Adami,per quello ci serve un altro po di tempo,7,10901200000,10919600000,18400000,211,0,0
Samurai Valerio,non ce n è più di tempo io devo chiudere,7,10920400000,10944400000,24000000,212,0,1
Livia Adami,devo risolvere un problema con mio fratello,7,10948000000,10968400000,20400000,213,0,0
Samurai Valerio,è il caso che intervenga io,7,10986000000,11002800000,16800000,214,0,1
Livia Adami,no,7,11006400000,11015600000,9200000,215,0,0
Livia Adami,le cose di ostia me le risolvo da sola,7,11016400000,11037200000,20800000,216,0,0
Sara Monaschi,dott trieste,7,11431200000,11440000000,8800000,218,0,0
Sara Monaschi,posso disturbarla un attimo,7,11450000000,11464400000,14400000,220,0,0
Samurai Valerio,come fai a dirlo,7,11527600000,11537600000,10000000,223,0,1
Samurai Valerio,mancano pochi giorni alle dimissioni del sindaco,7,11640800000,11663600000,22800000,228,0,1
Samurai Valerio,ancora non abbiamo niente in mano,7,11664400000,11681200000,16800000,229,0,1
Samurai Valerio,quand è la prossima riunione,7,11704800000,11721200000,16400000,230,0,1
Samurai Valerio,sara monaschi ci ha preso in giro fin dall inizio,7,11918800000,11940400000,21600000,232,0,1
Samurai Valerio,s è tenuta il prete per sé e adesso è ancora in corsa per l affare,7,11945200000,11974000000,28800000,233,0,1
Samurai Valerio,quella tratta direttamente in vaticano,7,11992000000,12010000000,18000000,235,0,1
Samurai Valerio,è più forte di noi là dentro,7,12014800000,12029600000,14800000,236,0,1
Samurai Valerio,magari,7,12083600000,12095200000,11600000,238,0,1
Samurai Valerio,non si può fare in quel modo,7,12100800000,12116400000,15600000,239,0,1
Samurai Valerio,ci devo pensare io,7,12124000000,12135600000,11600000,240,0,1
Sara Monaschi,no,7,12150800000,12168000000,17200000,242,0,0
Sara Monaschi,era un caro amico,7,12176000000,12190000000,14000000,243,0,0
Sara Monaschi,padre theodosiou era un uomo molto complesso contraddittorio,7,12220000000,12266000000,46000000,245,0,0
Sara Monaschi,e se si dovesse venire a scoprire qualcosa sulla sua morte,7,12277200000,12324400000,47200000,246,0,0
Sara Monaschi,che ne mettesse in dubbio la sua integrità,7,12325200000,12348400000,23200000,247,0,0
Sara Monaschi,per esempio che si fosse suicidato,7,12358000000,12385600000,27600000,248,0,0
Sara Monaschi,stiamo parlando di un uomo di chiesa dottore,7,12450800000,12471600000,20800000,251,0,0
Sara Monaschi,mi chiedevo se potevamo fare qualcosa assieme per farlo riposare in pace,7,12479600000,12511600000,32000000,252,0,0
Sara Monaschi,un gesto di umanità che ne salvi la memoria,7,12522400000,12545200000,22800000,253,0,0
Sara Monaschi,esatto,7,12566000000,12576000000,10000000,255,0,0
Sara Monaschi,una dichiarazione che attesti che padre theodosiou ha avuto un malore,7,12627200000,12665200000,38000000,258,0,0
Sara Monaschi,in conseguenza di quello è caduto dalla finestra,7,12677200000,12701600000,24400000,259,0,0
Sara Monaschi,una cortesia che potrei contraccambiare,7,12704800000,12732400000,27600000,260,0,0
Sara Monaschi,se lei ha un ente o non so una fondazione,7,12735200000,12765600000,30400000,261,0,0
Sara Monaschi,potremmo concordare una cifra potrei contribuire,7,12780800000,12820800000,40000000,262,0,0
Sara Monaschi,un contributo,7,12853600000,12863600000,10000000,264,0,0
Sara Monaschi,se lei si rendesse disponibile,7,12881600000,12904800000,23200000,265,0,0
Sara Monaschi,possiamo definirla assieme,7,12998000000,13018000000,20000000,269,0,0
Sara Monaschi,scusi aspetti un attimo,7,13037600000,13054000000,16400000,270,0,0
Sara Monaschi,non era questo che avevo in mente,7,13068800000,13088400000,19600000,271,0,0
Sara Monaschi,non pensavo,7,13089200000,13101200000,12000000,272,0,0
Sara Monaschi,mi lasci,7,13180400000,13197600000,17200000,278,0,0
Sara Monaschi,mi lasci ho detto,7,13198400000,13225200000,26800000,280,0,0
Samurai Valerio,uno che tua moglie crede di prendere in giro,7,13986800000,14009200000,22400000,307,0,1
Samurai Valerio,la dovete smettere,7,14080000000,14092400000,12400000,309,0,1
Samurai Valerio,è per il vostro bene,7,14102400000,14113600000,11200000,310,0,1
Samurai Valerio,nessuno,7,14144400000,14154000000,9600000,312,0,1
Samurai Valerio,t ho fatto l onore di venire personalmente,7,14162800000,14183600000,20800000,313,0,1
Samurai Valerio,di a tua moglie di fare quello che mi ha promesso,7,14230800000,14252000000,21200000,315,0,1
Samurai Valerio,hai capito chi sono io,7,14278800000,14289600000,10800000,316,0,1
Samurai Valerio,asciugati sei tutto sudato,7,14344400000,14362800000,18400000,317,0,1
Gabriele Marchilli,dove cazzo sta il prete dove cazzo sta,7,14612000000,14638400000,26400000,318,1,1
Gabriele Marchilli,entra,7,14724000000,14739200000,15200000,319,0,1
Gabriele Marchilli,entra,7,14744000000,14752400000,8400000,320,0,1
Alberto Anacleti,oh hai sentito quello che t ha detto,7,14753200000,14780000000,26800000,322,0,1
Gabriele Marchilli,t ho detto che devi entrare,7,14787200000,14804000000,16800000,323,0,1
Gabriele Marchilli,sto maiale,7,14813200000,14826400000,13200000,324,0,1
Gabriele Marchilli,entra,7,14827200000,14835600000,8400000,325,0,1
Aureliano Adami,a posto cinque minuti ed è pronto,7,14934800000,14953600000,18800000,326,0,1
Gabriele Marchilli,ecco la dichiarazione,7,15104000000,15114000000,10000000,328,0,1
Gabriele Marchilli,quella vecchia e quella nuova,7,15120800000,15145200000,24400000,329,0,1
Aureliano Adami,ci ha messo un attimo a scriverla,7,15155200000,15173200000,18000000,330,0,1
Alberto Anacleti,si vede che non gli piaceva la compagnia,7,15174000000,15194000000,20000000,331,0,1
Aureliano Adami,non ci guardare ha fatto tutto lele,7,15218000000,15237600000,19600000,332,0,1
Sara Monaschi,grazie,7,15279600000,15288000000,8400000,333,0,0
Amedeo Cinaglia,presiedo la commissione non faccio mica il cane da guardia,7,15429200000,15459200000,30000000,335,0,1
Amedeo Cinaglia,fumi pure tranquillo,7,15464000000,15475200000,11200000,336,0,1
Amedeo Cinaglia,ce l ho grazie,7,15526400000,15534800000,8400000,337,0,1
Amedeo Cinaglia,mi ricordo certe riunioni anni fa,7,15555200000,15573600000,18400000,338,0,1
Amedeo Cinaglia,con le sale,7,15600000000,15609600000,9600000,339,0,1
Amedeo Cinaglia,che erano camere a gas,7,15618400000,15631600000,13200000,340,0,1
Amedeo Cinaglia,la politica non l appassiona più,7,15698800000,15716800000,18000000,342,0,1
Amedeo Cinaglia,posso capirla,7,15736400000,15745200000,8800000,343,0,1
Amedeo Cinaglia,io e lei siamo stati usati come ruote di scorta,7,15758000000,15778800000,20800000,344,0,1
Amedeo Cinaglia,piazzati lì dove serviva al momento,7,15787600000,15806800000,19200000,345,0,1
Amedeo Cinaglia,ma la politica quella vera la facevano gli altri,7,15815600000,15844000000,28400000,346,0,1
Amedeo Cinaglia,però la sua passione è l arte,7,15885200000,15897600000,12400000,347,0,1
Amedeo Cinaglia,il suo sogno i musei di roma giusto,7,15906000000,15923600000,17600000,348,0,1
Amedeo Cinaglia,non sarebbe bello recuperarlo questo sogno,7,15966000000,15988400000,22400000,350,0,1
Amedeo Cinaglia,quella nomina,7,16006800000,16017600000,10800000,351,0,1
Amedeo Cinaglia,direttore dei musei di roma,7,16041200000,16058400000,17200000,352,0,1
Amedeo Cinaglia,è pronta,7,16074800000,16084000000,9200000,353,0,1
Amedeo Cinaglia,ha la firma,7,16096000000,16105200000,9200000,354,0,1
Amedeo Cinaglia,certe occasioni passano una volta sola nella vita,7,16233200000,16257200000,24000000,356,0,1
Amedeo Cinaglia,sarebbe un peccato sprecarle,7,16258000000,16275200000,17200000,357,0,1
Amedeo Cinaglia,si prenda un po di tempo per pensarci,7,16296400000,16318800000,22400000,358,0,1
Amedeo Cinaglia,fino a stasera,7,16339600000,16350800000,11200000,359,0,1
Sara Monaschi,perché ho anche questo,7,16576800000,16591200000,14400000,362,0,0
Sara Monaschi,che possiamo denunciare tutto,7,16691200000,16706000000,14800000,364,0,0
Sara Monaschi,far venire alla luce la verità,7,16710400000,16728800000,18400000,365,0,0
Sara Monaschi,monsignore era un brav uomo ma anche un grande peccatore,7,16735600000,16773600000,38000000,366,0,0
Sara Monaschi,il suicidio,7,16797600000,16808800000,11200000,367,0,0
Sara Monaschi,si aprirebbe un inchiesta,7,16819200000,16834400000,15200000,368,0,0
Sara Monaschi,questo scandalo scoppierebbe proprio qua dentro,7,16847200000,16876800000,29600000,369,0,0
Sara Monaschi,accanto al santo padre,7,16877600000,16888800000,11200000,370,0,0
Sara Monaschi,oppure,7,16895600000,16904000000,8400000,371,0,0
Sara Monaschi,possiamo certificare che theodosiou sia morto per cause naturali,7,16907200000,16951200000,44000000,372,0,0
Sara Monaschi,che i terreni vengano ceduti alla società che theodosiou aveva indicato,7,16976800000,17017600000,40800000,374,0,0
Sara Monaschi,quella di mio marito,7,17029600000,17042000000,12400000,375,0,0
Sara Monaschi,cioè la edilcigno,7,17048000000,17061600000,13600000,376,0,0
Sara Monaschi,ovvio,7,17212800000,17222000000,9200000,379,0,0
Samurai Valerio,mi arrivano strane voci su aureliano adami,7,17466400000,17490400000,24000000,380,0,1
Samurai Valerio,è vero che vuole tenersi certi terreni lì a ostia,7,17499600000,17522000000,22400000,381,0,1
Gabriele Marchilli,non lo so,7,17534000000,17543600000,9600000,382,0,1
Gabriele Marchilli,so che voleva sistemare uno stabilimento ma che il padre non era d accordo,7,17556000000,17598800000,42800000,383,0,1
Samurai Valerio,nient altro,7,17599600000,17610000000,10400000,384,0,1
Gabriele Marchilli,no,7,17610800000,17619200000,8400000,385,0,1
Samurai Valerio,tu lo sai che a me devi dire tutto vero gabrie,7,17662400000,17686000000,23600000,386,0,1
Samurai Valerio,se dovessi pensare che non mi servi più a un cazzo,7,17700000000,17721200000,21200000,387,1,1
Gabriele Marchilli,non so altro lo giuro,7,17722000000,17748400000,26400000,388,0,1
Samurai Valerio,ecco allora informati,7,17722000000,17748400000,26400000,389,0,1
Samurai Valerio,voglio sapere che gli passa in testa,7,17759200000,17776800000,17600000,390,0,1
Samurai Valerio,vai,7,17782400000,17790800000,8400000,391,0,1
Gabriele Marchilli,papà,7,18208000000,18216800000,8800000,394,0,1
Gabriele Marchilli,le hai fatte te ste polpette,7,18281600000,18296000000,14400000,395,0,1
Gabriele Marchilli,che ti sei messo a cucinare,7,18305600000,18318800000,13200000,396,0,1
Gabriele Marchilli,che c è,7,18437600000,18446000000,8400000,397,0,1
Gabriele Marchilli,come con samurai,7,18537600000,18548400000,10800000,399,0,1
Gabriele Marchilli,guarda che stai a sbagliare,7,18607200000,18630000000,22800000,401,0,1
Gabriele Marchilli,papà ti stai sbagliando,7,18651200000,18664400000,13200000,404,0,1
Gabriele Marchilli,non t azzardare più a toccarmi capito,7,18797600000,18818400000,20800000,409,0,1
Gabriele Marchilli,che cazzo stai facendo,7,18836000000,18846400000,10400000,412,1,1
Gabriele Marchilli,quello che dovevo fare da un pezzo,7,18852000000,18869600000,17600000,413,0,1
Sara Monaschi,stasera si riuniscono e votano,7,19142800000,19160800000,18000000,416,0,0
Sara Monaschi,ti ha minacciato,7,19278400000,19288000000,9600000,419,0,0
Sara Monaschi,non te l ho portato io,7,19354800000,19370000000,15200000,422,0,0
Sara Monaschi,quello è disperato,7,19379200000,19389200000,10000000,423,0,0
Sara Monaschi,gli stiamo togliendo la terra da sotto i piedi,7,19390000000,19410400000,20400000,424,0,0
Sara Monaschi,ma io lo voglio concludere quest affare non mi faccio impressionare da lui,7,19428800000,19461600000,32800000,425,0,0
Sara Monaschi,ho appena convinto la commissione a scegliere la nostra società,7,19466800000,19500800000,34000000,426,0,0
Sara Monaschi,stasera ci prendiamo i terreni,7,19516000000,19534800000,18800000,427,0,0
Sara Monaschi,se conti ancora qualcosa lo devi soltanto a me lo sai,7,19559600000,19589200000,29600000,429,0,0
Sara Monaschi,sì lo so ma qui non ammazza nessuno,7,19658000000,19677200000,19200000,431,0,0
Sara Monaschi,non si fanno così gli affari,7,19684800000,19698800000,14000000,432,0,0
Sara Monaschi,lo sa anche lui,7,19702400000,19712800000,10400000,433,0,0
Sara Monaschi,ho una commissione da fare,7,19738400000,19752800000,14400000,434,0,0
Aureliano Adami,sono io facciamo pace,7,20102000000,20126400000,24400000,439,0,1
Aureliano Adami,che è successo,7,20264000000,20274000000,10000000,440,0,1
Aureliano Adami,chi è stato,7,20469200000,20479600000,10400000,442,0,1
Sara Monaschi,ti ha cacciato di casa,7,20541200000,20555200000,14000000,444,0,0
Gabriele Marchilli,sì,7,20573200000,20581599999,8399999,445,0,1
Sara Monaschi,ma dai sarà un cazzata una lite tra padre e figlio,7,20592800001,20626000000,33199999,446,1,0
Gabriele Marchilli,no non è una cazzata,7,20640800000,20651200000,10400000,447,1,1
Sara Monaschi,ma lui ha capito quello che stai facendo,7,20664400000,20681200000,16800000,448,0,0
Gabriele Marchilli,no non sa niente,7,20686000000,20697600000,11600000,449,0,1
Sara Monaschi,allora che cosa è successo,7,20711200000,20724000000,12800000,450,0,0
Gabriele Marchilli,lascia stare non mi va di parlarne,7,20755600000,20776799999,21199999,451,0,1
Sara Monaschi,e perché mi hai chiamato se non ti va di parlarne,7,20777600000,20800000000,22400000,452,0,0
Gabriele Marchilli,perché avevo voglia di stare con te,7,20844000000,20861999999,17999999,453,0,1
Gabriele Marchilli,e ho bisogno di un posto dove andare,7,20887600000,20905200000,17600000,454,0,1
Sara Monaschi,hai fatto una cosa bella per me oggi,7,20989600000,21006800000,17200000,455,0,0
Sara Monaschi,grazie,7,21038000000,21050000000,12000000,456,0,0
Manfredi Anacleti,ma dove vai tutto il giorno invece di lavorare,7,21129200000,21151600000,22400000,457,0,1
Manfredi Anacleti,eh,7,21158400000,21166800000,8400000,458,0,1
Manfredi Anacleti,spadi io ti sto facendo crescere per farti diventare un capo,7,21176000000,21208800000,32800000,459,0,1
Manfredi Anacleti,ma gli uomini vedono sempre che non fai un cazzo,7,21209600000,21238400000,28800000,460,1,1
Manfredi Anacleti,sai questi che diranno spadino chi,7,21273200000,21298800000,25600000,461,0,1
Manfredi Anacleti,chi è spadino,7,21305200000,21316000000,10800000,462,0,1
Manfredi Anacleti,ci stiamo allargando,7,21329200000,21344800000,15600000,463,0,1
Manfredi Anacleti,i sale sono importanti,7,21347600000,21363200000,15600000,464,0,1
Manfredi Anacleti,il matrimonio era la prima cosa che facevamo insieme,7,21369600000,21394800000,25200000,465,0,1
Manfredi Anacleti,e tu sei partito subito col piede sbagliato,7,21395600000,21416400000,20800000,466,0,1
Manfredi Anacleti,eh che devono dire di noi,7,21417200000,21437200000,20000000,467,0,1
Manfredi Anacleti,ma allora si può sapere dove cazzo vai tutto il giorno,7,21454800000,21487200000,32400000,468,1,1
Manfredi Anacleti,prendimi quel tubo,7,21508000000,21518800000,10800000,469,0,1
Manfredi Anacleti,ahó prendimi quel tubo,7,21528400000,21544800000,16400000,470,0,1
Manfredi Anacleti,non si può sapere dove vai,7,21573200000,21606000000,32800000,471,0,1
Manfredi Anacleti,spadi io ti voglio bene ma non mi devi fare incazzare,7,21606800000,21634800000,28000000,472,1,1
Manfredi Anacleti,io ti ammazzo quando mi pare,7,21645200000,21659200000,14000000,474,0,1
Angelica Sale,avete litigato un altra volta,7,22156000000,22171600000,15600000,478,0,0
Alberto Anacleti,dammi quella felpa,7,22177600000,22191200000,13600000,479,0,1
Alberto Anacleti,dai,7,22218400000,22227600000,9200000,480,0,1
Manfredi Anacleti,c è da fare una consegna,7,22309200000,22320400000,11200000,481,0,1
Manfredi Anacleti,tocca cominciare a far muovere quel bar se no credono che abbiamo scherzato,7,22321200000,22358000000,36800000,482,0,1
Manfredi Anacleti,ci vai te,7,22364400000,22373600000,9200000,483,0,1
Manfredi Anacleti,non ho capito,7,22397600000,22408000000,10400000,484,0,1
Alberto Anacleti,sì ci vado io,7,22426400000,22443600000,17200000,485,0,1
Alberto Anacleti,ordina e ordina che cazzo si ordina,7,22554400000,22578000000,23600000,487,1,1
Angelica Sale,è perché si fida di te,7,22596400000,22609600000,13200000,488,0,0
Alberto Anacleti,sì,7,22610400000,22624000000,13600000,489,0,1
Contessa Sveva Della Rocca Croce,allora,7,22829600000,22838000000,8400000,490,0,0
Sara Monaschi,è andato tutto bene,7,22851200000,22872000000,20800000,491,0,0
Contessa Sveva Della Rocca Croce,brava,7,22851200000,22872000000,20800000,492,0,0
Contessa Sveva Della Rocca Croce,lo sapevo,7,22890400000,22900000000,9600000,493,0,0
Contessa Sveva Della Rocca Croce,la prima volta che ti ho visto mi è sembrato di rivedere me stessa,7,22910000000,22941200000,31200000,494,0,0
Contessa Sveva Della Rocca Croce,ho capito che tu mi avresti dato la rivincita che cercavo,7,22942000000,22970400000,28400000,495,0,0
Contessa Sveva Della Rocca Croce,raccontami tutto,7,22987600000,23000000000,12400000,496,0,0
Samurai Valerio,sì,7,23096800000,23105200000,8400000,498,0,1
Samurai Valerio,ho capito,7,23164800000,23176000000,11200000,499,0,1
Samurai Valerio,sara monaschi si è presa i terreni di ostia,7,23193600000,23217200000,23600000,500,0,1
Samurai Valerio,quelli dei preti,7,23221200000,23231600000,10400000,501,0,1
Aureliano Adami,alzati in piedi,7,23382000000,23391200000,9200000,503,0,1
Aureliano Adami,che pezzo di merda,7,23419200000,23433600000,14400000,504,1,1
Manfredi Anacleti,spadino ha fatto quello che doveva fare,7,24084800000,24102000000,17200000,508,0,1
Angelica Sale,sì,7,24112000000,24120400000,8400000,509,0,0
Manfredi Anacleti,colpisci,7,24142400000,24156800000,14400000,510,0,1
Manfredi Anacleti,ammazzalo,7,24162000000,24177600000,15600000,511,0,1
Amedeo Cinaglia,buonasera,7,24285600000,24294000000,8400000,513,0,1
Amedeo Cinaglia,bravo taccon,7,24369200000,24380000000,10800000,516,0,1
Amedeo Cinaglia,ha fatto la scelta giusta,7,24391600000,24405600000,14000000,517,0,1
Amedeo Cinaglia,approvi in commissione,7,24411600000,24424800000,13200000,518,0,1
Amedeo Cinaglia,e avrà i musei,7,24435200000,24446000000,10800000,519,0,1
Amedeo Cinaglia,buonanotte,7,24464000000,24473600000,9600000,520,0,1
Angelica Sale,ah,7,24864400000,24876000000,11600000,522,0,0
Alberto Anacleti,allora è fatta è andata,7,25313200000,25330400000,17200000,528,0,1
Aureliano Adami,mo che si fa,7,25331200000,25342400000,11200000,529,0,1
Sara Monaschi,adesso ci sono tutti gli adempimenti burocratici,7,25343200000,25367600000,24400000,530,0,0
Sara Monaschi,il passaggio del protocollo e tutte le formalità del caso,7,25372000000,25400000000,28000000,531,0,0
Alberto Anacleti,che cazzo ha detto,7,25413200000,25428000000,14800000,532,1,1
Aureliano Adami,che sei in affari datti una sistemata comprati una camicia una cosa,7,25430800000,25461600000,30800000,533,0,1
Alberto Anacleti,ahó ti stai zitto,7,25462400000,25474800000,12400000,534,0,1
Aureliano Adami,hai visto che ti è convenuto a metterti con noi mona,7,25504800000,25538400000,33600000,535,1,1
Sara Monaschi,beh non è che avessi molte alternative,7,25539200000,25557200000,18000000,536,0,0
Aureliano Adami,va bene è stato un piacere io me ne vado,7,25583600000,25604800000,21200000,537,0,1
Alberto Anacleti,ahó,7,25605600000,25614000000,8400000,538,0,1
Alberto Anacleti,ma come,7,25618800000,25627200000,8400000,539,0,1
Alberto Anacleti,io pensavo che stavamo insieme che festeggiavamo,7,25629200000,25651200000,22000000,540,0,1
Aureliano Adami,no frate ho da fare con isabel facciamo un altra volta,7,25652000000,25675600000,23600000,541,0,1
Alberto Anacleti,ma chi la negra,7,25680400000,25691200000,10800000,542,1,1
Aureliano Adami,eh si chiama isabel,7,25703200000,25714400000,11200000,544,0,1
Aureliano Adami,ciao spadi,7,25732800000,25742800000,10000000,545,0,1
Aureliano Adami,tocca dargli una pulita,7,26998000000,27010000000,12000000,548,0,1
Aureliano Adami,però è bella si vede il mare,7,27013200000,27030000000,16800000,549,0,1
Aureliano Adami,si sta bene qua,7,27078000000,27090000000,12000000,550,0,1
Aureliano Adami,voglio che stai qua con me,7,27236400000,27249200000,12800000,551,0,1
Contessa Sveva Della Rocca Croce,ciao,7,27558000000,27566400000,8400000,553,0,0
Samurai Valerio,è un piacere rivederti,7,27643600000,27659600000,16000000,554,0,1
Samurai Valerio,non sei cambiata per niente dall ultima volta che ci siamo visti,7,27690400000,27721200000,30800000,555,0,1
Contessa Sveva Della Rocca Croce,tu sì invece,7,27729200000,27740800000,11600000,556,0,0
Contessa Sveva Della Rocca Croce,e comunque fra me e te quella bella ero io,7,27756800000,27781200000,24400000,557,0,0
Samurai Valerio,e io chi ero,7,27802800000,27812800000,10000000,558,0,1
Contessa Sveva Della Rocca Croce,un delinquente,7,27836000000,27848800000,12800000,559,0,0
Contessa Sveva Della Rocca Croce,uno che m ha levato tutto quello che avevo,7,27868000000,27889200000,21200000,560,0,0
Contessa Sveva Della Rocca Croce,a cominciare da mio marito,7,27902000000,27920000000,18000000,561,0,0
Samurai Valerio,stai tirando fuori storie vecchie,7,27946400000,27962400000,16000000,562,0,1
Contessa Sveva Della Rocca Croce,non per me,7,27967600000,27977600000,10000000,563,0,0
Contessa Sveva Della Rocca Croce,non c è stato giorno in cui non ci abbia pensato,7,27993200000,28016800000,23600000,564,0,0
Samurai Valerio,quindi,7,28042000000,28050400000,8400000,565,0,1
Samurai Valerio,perché mi hai fatto venire qui,7,28070400000,28088400000,18000000,566,0,1
Samurai Valerio,hai qualcosa da offrirmi,7,28094800000,28106800000,12000000,567,0,1
Contessa Sveva Della Rocca Croce,sara monaschi,7,28119200000,28133600000,14400000,568,0,0
Alberto Anacleti,ah,8,770000000,778400000,8400000,12,0,1
Alberto Anacleti,ma che vuoi,8,862400000,879600000,17200000,15,0,1
Alberto Anacleti,io non ho fatto un cazzo,8,880400000,904800000,24400000,17,1,1
Contessa Sveva Della Rocca Croce,sara scusa se ti chiamo a quest ora,8,1302400000,1324800000,22400000,19,0,0
Contessa Sveva Della Rocca Croce,puoi venire a trovarmi domani mattina,8,1351600000,1372000000,20400000,20,0,0
Contessa Sveva Della Rocca Croce,ti devo parlare di una cosa molto importante,8,1386000000,1409600000,23600000,21,0,0
Contessa Sveva Della Rocca Croce,bene a domani,8,1436400000,1452000000,15600000,22,0,0
Samurai Valerio,abbiamo perso è vero ma ho già risolto tutto,8,1810000000,1835600000,25600000,25,0,1
Samurai Valerio,non c era bisogno di scomodarsi t avrei avvertito,8,1842000000,1866400000,24400000,26,0,1
Samurai Valerio,non potrei vivere da nessun altra parte,8,1982000000,2000400000,18400000,30,0,1
Samurai Valerio,vai sto bene,8,2754000000,2768400000,14400000,35,0,1
Alberto Anacleti,come stai,8,3164000000,3173600000,9600000,37,0,1
Angelica Sale,come una che s è presa una pallottola al posto di un altro,8,3176800000,3204800000,28000000,38,0,0
Alberto Anacleti,però io non ti ho chiesto di andarci al posto mio,8,3208400000,3228000000,19600000,39,0,1
Angelica Sale,tra moglie e marito si fa così,8,3233200000,3248800000,15600000,40,0,0
Angelica Sale,anche se è solo un graffio mi fa male,8,3374800000,3394400000,19600000,41,0,0
Angelica Sale,non sono tua sorella,8,3430400000,3446000000,15600000,42,0,0
Angelica Sale,è la seconda volta che ti copro,8,3488400000,3505600000,17200000,43,0,0
Angelica Sale,e non so neanche dove cazzo stavi,8,3513200000,3532000000,18800000,44,1,0
Angelica Sale,io mi sono stufata spadi,8,3535600000,3561200000,25600000,45,0,0
Alberto Anacleti,senti ange,8,3535600000,3561200000,25600000,46,0,1
Angelica Sale,dimmi,8,3579200000,3588000000,8800000,47,0,0
Alberto Anacleti,andiamo a dormire,8,3618000000,3632400000,14400000,48,0,1
Samurai Valerio,ne ho fatte tante in vita mia,8,3738000000,3752000000,14000000,49,0,1
Samurai Valerio,ma una fine così del cazzo non me la sarei mai immaginata,8,3752800000,3778800000,26000000,50,1,1
Samurai Valerio,ma poteva succedere questo è il problema,8,3811600000,3831200000,19600000,52,0,1
Samurai Valerio,e stava a succedere proprio a me,8,3832000000,3850400000,18400000,53,0,1
Samurai Valerio,a fare che,8,3888000000,3896400000,8400000,55,0,1
Samurai Valerio,ci tocca andare,8,4007200000,4017600000,10400000,57,0,1
Samurai Valerio,tra un po arrivano gli adami e gli zingari giù al maneggio,8,4028800000,4055200000,26400000,58,0,1
Manfredi Anacleti,allora non hai niente da dire,8,4255200000,4277600000,22400000,60,0,1
Alberto Anacleti,alla fine non è successo niente,8,4308000000,4322400000,14400000,61,0,1
Manfredi Anacleti,a momenti muore e tu dici che non è successo niente,8,4327200000,4352400000,25200000,62,0,1
Manfredi Anacleti,boh,8,4353200000,4361600000,8400000,63,0,1
Alberto Anacleti,va bene,8,4388000000,4410000000,22000000,64,0,1
Manfredi Anacleti,dove credi di andare,8,4388000000,4410000000,22000000,65,0,1
Manfredi Anacleti,tu devi venire con me,8,4410800000,4424800000,14000000,66,0,1
Manfredi Anacleti,pischello eri e pischello sei rimasto,8,4436800000,4461200000,24400000,67,0,1
Manfredi Anacleti,mo devi chiedere il permesso pure per andare al cesso,8,4462000000,4490800000,28800000,68,1,1
Amedeo Cinaglia,ma perché,8,4595600000,4604400000,8800000,70,0,1
Amedeo Cinaglia,lo sai che ci sono affezionato no,8,4628400000,4646400000,18000000,72,0,1
Amedeo Cinaglia,dici,8,4697200000,4722400000,25200000,74,0,1
Aureliano Adami,mi piace che stai qui,8,4938800000,4950400000,11600000,77,0,1
Aureliano Adami,che giri per casa,8,4959200000,4972000000,12800000,78,0,1
Aureliano Adami,dopo prendiamo la roba tua così la riempiamo,8,5025600000,5044800000,19200000,80,0,1
Livia Adami,non ti preoccupare ci sta romolo,8,5207600000,5224400000,16800000,82,0,0
Livia Adami,non sto da sola te l ho già detto,8,5263600000,5285200000,21600000,84,0,0
Livia Adami,ci sta romolo,8,5289600000,5300800000,11200000,85,0,0
Livia Adami,tranquillo,8,5308000000,5317200000,9200000,86,0,0
Livia Adami,dai,8,5366800000,5375600000,8800000,87,0,0
Manfredi Anacleti,tu resti qua a fare la guardia insieme agli altri,8,5560800000,5591200000,30400000,88,0,1
Samurai Valerio,errori ne avete fatti da tutte e due le parti,8,5699600000,5718400000,18800000,89,0,1
Samurai Valerio,però loro sono gli adami,8,5719200000,5735200000,16000000,90,0,1
Livia Adami,e tu la morte di mio padre la chiami un errore,8,5741600000,5761200000,19600000,91,0,0
Manfredi Anacleti,chiamala come ti pare ma noi non siamo stati,8,5768800000,5789200000,20400000,92,0,1
Livia Adami,no sono stata io,8,5797200000,5810400000,13200000,93,0,0
Manfredi Anacleti,è un problema tuo,8,5811200000,5823200000,12000000,94,0,1
Livia Adami,io al tavolo con uno zingaro non mi ci siedo,8,5836000000,5859200000,23200000,95,0,0
Samurai Valerio,aspetta,8,5860000000,5869600000,9600000,96,0,1
Samurai Valerio,gli uomini tuoi hanno fatto una cazzata giù al bar,8,5884800000,5908000000,23200000,97,1,1
Samurai Valerio,non vi dovevate permettere,8,5908800000,5922000000,13200000,98,0,1
Samurai Valerio,quindi adesso risarcite livia,8,5930000000,5944000000,14000000,99,0,1
Samurai Valerio,e ve ne tornate nelle vostre belle villette del cazzo,8,5944800000,5973600000,28800000,100,1,1
Manfredi Anacleti,ma che ne so io che gli adami si sono presi pure i baretti all eur,8,5980800000,6012400000,31600000,101,0,1
Samurai Valerio,ora lo sai,8,6013200000,6022800000,9600000,102,0,1
Manfredi Anacleti,ma questa già c ha tutta ostia a che le serve allargarsi fino all eur,8,6030400000,6069600000,39200000,103,0,1
Manfredi Anacleti,eh e noi un cazzo,8,6070400000,6086800000,16400000,104,1,1
Samurai Valerio,voi non siete un cazzo manfre,8,6087600000,6107200000,19600000,105,1,1
Samurai Valerio,loro sono gli adami,8,6108000000,6119200000,11200000,106,0,1
Manfredi Anacleti,gira voce che a tuo fratello di ostia non gliene frega più niente,8,6179200000,6212000000,32800000,107,0,1
Manfredi Anacleti,e tu da sola non ce la puoi fare,8,6228800000,6244800000,16000000,108,0,1
Livia Adami,tu ostia non la devi neanche nominare,8,6262000000,6280400000,18400000,109,0,0
Samurai Valerio,manfre abbiamo finito,8,6304800000,6317600000,12800000,110,0,1
Samurai Valerio,tu ora stai a posto io no,8,6444800000,6464400000,19600000,111,0,1
Samurai Valerio,sto aspettando ancora la firma tua e di tuo fratello,8,6472800000,6494000000,21200000,112,0,1
Samurai Valerio,per i terreni che mi hai promesso,8,6494800000,6514000000,19200000,113,0,1
Manfredi Anacleti,un cazzo che ma non lo usi il cervello,8,6525200000,6559200000,34000000,115,1,1
Manfredi Anacleti,per noi se stiamo qua è già una vittoria quando ci siamo mai seduti a sti tavoli,8,6602400000,6641600000,39200000,117,0,1
Manfredi Anacleti,andiamo dai,8,6648000000,6656400000,8400000,118,0,1
Amedeo Cinaglia,un giro per negozi,8,7220800000,7231600000,10800000,121,0,1
Amedeo Cinaglia,lo vedi che ti sbagliavi l ultima volta,8,7274400000,7291600000,17200000,124,0,1
Amedeo Cinaglia,dicevi che io e te non avevamo niente da dirci e invece guardaci qua,8,7297200000,7326800000,29600000,125,0,1
Amedeo Cinaglia,a parlare delle mie scarpe,8,7334400000,7348000000,13600000,126,0,1
Amedeo Cinaglia,come ai vecchi tempi,8,7354800000,7384800000,30000000,127,0,1
Amedeo Cinaglia,t ho deluso gabrie,8,7404800000,7417200000,12400000,130,0,1
Amedeo Cinaglia,pensavi che sarei rimasto al posto mio buono buono come sempre,8,7446400000,7476000000,29600000,132,0,1
Amedeo Cinaglia,e invece t ho deluso,8,7485200000,7497200000,12000000,133,0,1
Contessa Sveva Della Rocca Croce,le cose sono cambiate sara,8,7653600000,7672000000,18400000,134,0,0
Contessa Sveva Della Rocca Croce,i terreni di ostia li devi dare a samurai,8,7680800000,7707200000,26400000,135,0,0
Sara Monaschi,è uno scherzo,8,7714800000,7728000000,13200000,136,0,0
Contessa Sveva Della Rocca Croce,tuo marito rinuncia alla compravendita,8,7737200000,7758800000,21600000,137,0,0
Contessa Sveva Della Rocca Croce,e i terreni in automatico vanno alla ditta di samurai,8,7759600000,7787600000,28000000,138,0,0
Contessa Sveva Della Rocca Croce,manca solo la ratifica,8,7794000000,7808000000,14000000,139,0,0
Sara Monaschi,non capisco,8,7814000000,7824400000,10400000,140,0,0
Contessa Sveva Della Rocca Croce,cosa c è da capire,8,7827600000,7837600000,10000000,141,0,0
Contessa Sveva Della Rocca Croce,oppure pensi davvero che avrei invitato a casa mia un fallito come sandro,8,7846400000,7886000000,39600000,142,0,0
Contessa Sveva Della Rocca Croce,mi servivi tu per andare contro samurai,8,7894800000,7917200000,22400000,143,0,0
Contessa Sveva Della Rocca Croce,prima gli ho creato un ostacolo e poi gliel ho risolto,8,7924000000,7952000000,28000000,144,0,0
Contessa Sveva Della Rocca Croce,lui si prende i terreni e io mi riprendo l impero di mio marito,8,7955600000,7991200000,35600000,145,0,0
Contessa Sveva Della Rocca Croce,ed eccoci qua,8,7992000000,8005600000,13600000,146,0,0
Sara Monaschi,io a quei terreni non ci rinuncio,8,8012000000,8030000000,18000000,147,0,0
Contessa Sveva Della Rocca Croce,fallo,8,8033600000,8043600000,10000000,148,0,0
Contessa Sveva Della Rocca Croce,o ti denuncio per la storia di theodosiou,8,8048400000,8075600000,27200000,149,0,0
Sara Monaschi,non ha nessuna prova,8,8082800000,8110000000,27200000,150,0,0
Contessa Sveva Della Rocca Croce,ho il mio salotto,8,8082800000,8110000000,27200000,151,0,0
Contessa Sveva Della Rocca Croce,qualcuno parla della morte sospetta del monsignore,8,8121600000,8155200000,33600000,152,0,0
Contessa Sveva Della Rocca Croce,le voci corrono gli inquirenti cominciano a indagare,8,8156000000,8191600000,35600000,153,0,0
Contessa Sveva Della Rocca Croce,mettono in discussione l autopsia,8,8192400000,8214000000,21600000,154,0,0
Contessa Sveva Della Rocca Croce,e il medico legale crolla e racconta tutto,8,8219600000,8245200000,25600000,155,0,0
Contessa Sveva Della Rocca Croce,tu sara l hai costretto a coprire il suicidio,8,8257200000,8293200000,36000000,156,0,0
Contessa Sveva Della Rocca Croce,col tempo mi capirai,8,8314800000,8333200000,18400000,157,0,0
Contessa Sveva Della Rocca Croce,adesso vado che i poveri mi aspettano,8,8341200000,8365600000,24400000,158,0,0
Angelica Sale,com è andata,8,8659600000,8671200000,11600000,161,0,0
Alberto Anacleti,boh male ma pare bene,8,8691600000,8710000000,18400000,162,0,1
Angelica Sale,senti albe che mi stavi per dire stanotte,8,8745600000,8763200000,17600000,163,0,0
Angelica Sale,oh,8,8787200000,8795600000,8400000,164,0,0
Alberto Anacleti,ridammi il telefono,8,8827600000,8841600000,14000000,165,0,1
Alberto Anacleti,quando ti dico una cosa è quella,8,8869200000,8883600000,14400000,166,0,1
Angelica Sale,stavi con l amante tua vero perciò non vuoi fare l amore con me,8,8952800000,8982400000,29600000,167,0,0
Samurai Valerio,tu la monaschi e quelle altre due merde vi siete messi in società contro di me,8,9302000000,9342400000,40400000,169,1,1
Samurai Valerio,secondo te non lo scoprivo,8,9356400000,9370400000,14000000,170,0,1
Samurai Valerio,adesso ascolta,8,9405200000,9418800000,13600000,171,0,1
Samurai Valerio,tu me li hai messi davanti tu me li devi levare,8,9425200000,9451600000,26400000,172,0,1
Samurai Valerio,subito,8,9458000000,9466400000,8400000,173,0,1
Gabriele Marchilli,posso spiegare un attimo,8,9479200000,9492000000,12800000,174,0,1
Samurai Valerio,spiegami che fine ha fatto quel sorrisetto falso di prima,8,9496400000,9525600000,29200000,175,0,1
Samurai Valerio,dove l hai messo,8,9532000000,9542000000,10000000,176,0,1
Samurai Valerio,mo mi devi togliere dal cazzo gli amichetti tuoi,8,9552800000,9574800000,22000000,177,1,1
Gabriele Marchilli,ma come faccio,8,9593600000,9602800000,9200000,178,0,1
Samurai Valerio,me li porti a dama,8,9643200000,9656800000,13600000,179,0,1
Samurai Valerio,gli dai appuntamento a mezzanotte al parcheggio di piazza mancini,8,9666400000,9696000000,29600000,180,0,1
Samurai Valerio,e poi ci andiamo noi al posto tuo,8,9696800000,9711600000,14800000,181,0,1
Samurai Valerio,se no racconto quello che hai fatto a tullio adami prima a tuo padre,8,9712400000,9742800000,30400000,182,0,1
Samurai Valerio,e poi ad aureliano,8,9743600000,9757200000,13600000,183,0,1
Gabriele Marchilli,e a me,8,9791600000,9801200000,9600000,184,0,1
Gabriele Marchilli,a me che succede,8,9820800000,9830800000,10000000,185,0,1
Samurai Valerio,il figlio di una guardia serve sempre,8,9869200000,9888000000,18800000,186,0,1
Aureliano Adami,ahó,8,10488400000,10497600000,9200000,187,0,1
Alberto Anacleti,lele l hai sentito,8,10502400000,10513600000,11200000,188,0,1
Aureliano Adami,no,8,10519200000,10528400000,9200000,189,0,1
Alberto Anacleti,la monaschi che fine ha fatto che ci vuole a mettere una firma,8,10536400000,10565200000,28800000,190,0,1
Aureliano Adami,che cazzo ne so spadi ci vorrà un po mi hai chiamato per questo,8,10579200000,10612800000,33600000,191,1,1
Alberto Anacleti,ti ho chiamato perché oggi le nostre famiglie,8,10634800000,10658400000,23600000,192,0,1
Alberto Anacleti,si sono viste da samurai,8,10659200000,10669200000,10000000,193,0,1
Alberto Anacleti,hanno fatto un patto ma secondo me non dura molto,8,10678800000,10706400000,27600000,194,0,1
Aureliano Adami,sono cazzi loro,8,10730000000,10740800000,10800000,195,1,1
Alberto Anacleti,eh magari,8,10743600000,10753200000,9600000,196,0,1
Alberto Anacleti,ieri un altro po e la donna mia ci rimaneva secca al baretto,8,10758400000,10783200000,24800000,197,0,1
Aureliano Adami,che cazzo stava a fare là,8,10795600000,10809200000,13600000,198,1,1
Alberto Anacleti,niente dovevo fare una consegna e ci è andata lei al posto mio,8,10824000000,10851600000,27600000,199,0,1
Aureliano Adami,che s è fatta,8,10881600000,10890800000,9200000,200,0,1
Alberto Anacleti,niente per fortuna,8,10900400000,10912400000,12000000,201,0,1
Aureliano Adami,meno male,8,10923600000,10933600000,10000000,202,0,1
Aureliano Adami,frate io me ne devo andare ho da fare il trasloco con isabel,8,11032400000,11062400000,30000000,203,0,1
Aureliano Adami,stai tranquillo,8,11063200000,11074000000,10800000,204,0,1
Alberto Anacleti,te la stai portando a casa,8,11080000000,11093200000,13200000,205,0,1
Aureliano Adami,ci dovrò provare pure io no,8,11105200000,11118400000,13200000,206,0,1
Aureliano Adami,sta meglio a te che a me sto cappello tieni te lo regalo,8,11160000000,11188000000,28000000,207,0,1
Aureliano Adami,va da tua moglie che c ha bisogno,8,11202000000,11218800000,16800000,208,0,1
Livia Adami,hai ragione,8,11568000000,11579600000,11600000,210,0,0
Livia Adami,ma aureliano non ha ancora firmato,8,11590400000,11606400000,16000000,211,0,0
Livia Adami,e samurai vuole subito i terreni che gli ho promesso,8,11607200000,11633200000,26000000,212,0,0
Livia Adami,se mi risponde chissà che sta a fare,8,11693200000,11711200000,18000000,214,0,0
Livia Adami,che dovrebbe essere qua in questa famiglia,8,11732400000,11757200000,24800000,216,0,0
Livia Adami,che mi stai a dire,8,11811200000,11820400000,9200000,218,0,0
Livia Adami,eh,8,11832000000,11840400000,8400000,219,0,0
Livia Adami,non può essere ma che dici,8,11911200000,11935200000,24000000,221,0,0
Livia Adami,una negra del cazzo,8,11982800000,11992400000,9600000,224,1,0
Livia Adami,spiccicato a mio padre,8,12054800000,12068800000,14000000,226,0,0
Livia Adami,e dove stanno,8,12176400000,12187200000,10800000,228,0,0
Livia Adami,dimmi dove cazzo stanno,8,12223200000,12236800000,13600000,230,1,0
Gabriele Marchilli,papà,8,12854400000,12863600000,9200000,234,0,1
Gabriele Marchilli,papà mi devi aiutare,8,12904400000,12916000000,11600000,235,0,1
Gabriele Marchilli,ti racconto tutto,8,12978000000,12987600000,9600000,237,0,1
Gabriele Marchilli,senza bugie,8,13004000000,13012400000,8400000,238,0,1
Gabriele Marchilli,stavolta no,8,13100000000,13117600000,17600000,240,0,1
Gabriele Marchilli,sono tutte storie del cazzo giri da poco,8,13213200000,13240000000,26800000,243,1,1
Gabriele Marchilli,mi hanno chiesto di partecipare a uno scambio stasera,8,13355200000,13378000000,22800000,246,0,1
Gabriele Marchilli,mezzo etto di coca,8,13386400000,13396000000,9600000,247,0,1
Gabriele Marchilli,lo devono portare due ragazzi,8,13413200000,13428400000,15200000,248,0,1
Gabriele Marchilli,senti un conto è qualche pippata a una festa,8,13464000000,13484800000,20800000,249,0,1
Gabriele Marchilli,ma io non ho mai spacciato in vita mia e non voglio cominciare stasera,8,13501200000,13532000000,30800000,250,0,1
Gabriele Marchilli,me la voglio riprendere in mano la vita mia,8,13540000000,13557600000,17600000,251,0,1
Gabriele Marchilli,che succede,8,13714400000,13722800000,8400000,259,0,1
Gabriele Marchilli,stronzi te l ho detto sono due ragazzi come me,8,13761600000,13783600000,22000000,261,0,1
Gabriele Marchilli,tu però mi prometti che ne resti fuori,8,13898400000,13917200000,18800000,263,0,1
Gabriele Marchilli,grazie,8,13972400000,13980800000,8400000,264,0,1
Gabriele Marchilli,alle dieci,8,14007200000,14015600000,8400000,266,0,1
Gabriele Marchilli,davanti alla chiesa dell isola tiberina,8,14025600000,14044000000,18400000,267,0,1
Gabriele Marchilli,uno è alto e biondo e l altro ha la cresta,8,14053600000,14074800000,21200000,268,0,1
Sara Monaschi,so solo che ce l avevamo quasi fatta,8,14492800000,14509200000,16400000,278,0,0
Sara Monaschi,forse una soluzione ancora c è,8,14609200000,14624800000,15600000,281,0,0
Sara Monaschi,ci devo provare,8,14736000000,14747200000,11200000,284,0,0
Sara Monaschi,arrivederci,8,14772000000,14780400000,8400000,285,0,0
Manfredi Anacleti,aiutami un po,8,14940400000,14953200000,12800000,287,0,1
Manfredi Anacleti,sei stata coraggiosa ieri,8,15062800000,15077200000,14400000,288,0,1
Manfredi Anacleti,sta cazzo di cravatta mi sta strozzando al manicomio mi manda,8,15113200000,15146800000,33600000,289,1,1
Angelica Sale,mo raccolgo tutto,8,15152800000,15166400000,13600000,290,0,0
Angelica Sale,è tuo figlio che deve ricordarsi di avere una moglie,8,15261200000,15285600000,24400000,293,0,0
Angelica Sale,mi sa che ce ne ha un altro di problema e pure bello grosso vero,8,15336000000,15366800000,30800000,295,0,0
Angelica Sale,io non so che devo fare,8,15420000000,15438800000,18800000,297,0,0
Angelica Sale,ma se mio marito non mi vuole io qua che ci resto a fare,8,15478800000,15504800000,26000000,300,0,0
Sara Monaschi,mi chiamo sara monaschi ho bisogno di parlare con lei,8,16045200000,16073200000,28000000,306,0,0
Sara Monaschi,io e lei abbiamo una cosa in comune,8,16098800000,16119200000,20400000,308,0,0
Sara Monaschi,samurai,8,16123600000,16132000000,8400000,309,0,0
Sara Monaschi,ci ha usati entrambi,8,16142000000,16156800000,14800000,310,0,0
Sara Monaschi,lavoro in vaticano e posso dargli molto fastidio,8,16175600000,16208400000,32800000,312,0,0
Sara Monaschi,ma mi serve qualcosa da poter usare contro di lui,8,16211600000,16232800000,21200000,313,0,0
Sara Monaschi,posso proteggerla,8,16242800000,16254400000,11600000,314,0,0
Sara Monaschi,ma lei non deve esporsi,8,16326000000,16339600000,13600000,317,0,0
Sara Monaschi,mi deve dare qualcosa la faccia ce la metto io,8,16342800000,16364800000,22000000,318,0,0
Sara Monaschi,la mafia,8,16438800000,16448000000,9200000,321,0,0
Sara Monaschi,e allora mi dia una prova qualcosa,8,16463600000,16480800000,17200000,322,0,0
Aureliano Adami,oh frate,8,16784800000,16795200000,10400000,325,0,1
Gabriele Marchilli,come va,8,16829200000,16842800000,13600000,326,0,1
Aureliano Adami,che dici,8,16829200000,16842800000,13600000,327,0,1
Gabriele Marchilli,bene e te,8,16843600000,16852800000,9200000,328,0,1
Aureliano Adami,come stiamo messi con la monaschi,8,16911200000,16928000000,16800000,329,0,1
Gabriele Marchilli,vi ho chiamato per questo,8,16928800000,16941200000,12400000,330,0,1
Gabriele Marchilli,sara ha organizzato una serata per la ratifica di sta firma,8,16956800000,16983200000,26400000,331,0,1
Gabriele Marchilli,ha bisogno di un bel po di merce,8,16987200000,17005600000,18400000,332,0,1
Alberto Anacleti,che problema c è ci pensiamo noi,8,17011600000,17035600000,24000000,333,0,1
Gabriele Marchilli,grazie,8,17011600000,17035600000,24000000,334,0,1
Aureliano Adami,dove ci vediamo,8,17057200000,17069600000,12400000,335,0,1
Gabriele Marchilli,alle dieci all isola tiberina,8,17070400000,17086400000,16000000,336,0,1
Alberto Anacleti,isola tiberina alle dieci sì,8,17094400000,17111600000,17200000,337,0,1
Aureliano Adami,va bene,8,17112400000,17123200000,10800000,338,0,1
Aureliano Adami,dove cazzo vai siediti facciamo un brindisi,8,17136400000,17154800000,18400000,339,1,1
Alberto Anacleti,qua tocca festeggiare,8,17155600000,17172000000,16400000,340,0,1
Aureliano Adami,dai belli,8,17182400000,17191200000,8800000,341,0,1
Aureliano Adami,va bene io ho un sacco di cazzi da fare mo mi organizzo pure per sta merce,8,17268400000,17299600000,31200000,342,1,1
Alberto Anacleti,andiamo finisci dopo sta birra,8,17307600000,17324000000,16400000,343,0,1
Aureliano Adami,forza ciao le,8,17327600000,17343600000,16000000,344,0,1
Alberto Anacleti,ciao bello,8,17327600000,17343600000,16000000,345,0,1
Sara Monaschi,il campidoglio,8,17530800000,17546800000,16000000,346,0,0
Sara Monaschi,me lo immaginavo più sfarzoso,8,17552000000,17568800000,16800000,347,0,0
Amedeo Cinaglia,beh lo è,8,17573600000,17584800000,11200000,348,0,1
Amedeo Cinaglia,solo non questo ufficio,8,17585600000,17598400000,12800000,349,0,1
Amedeo Cinaglia,ma è la prima volta che ci viene,8,17617200000,17639600000,22400000,350,0,1
Sara Monaschi,no,8,17617200000,17639600000,22400000,351,0,0
Sara Monaschi,ma ogni volta penso la stessa cosa,8,17640400000,17658800000,18400000,352,0,0
Sara Monaschi,ha figli,8,17684000000,17696800000,12800000,353,0,0
Amedeo Cinaglia,sì,8,17705600000,17715200000,9600000,354,0,1
Amedeo Cinaglia,e lei,8,17722400000,17737200000,14800000,355,0,1
Sara Monaschi,no,8,17722400000,17737200000,14800000,356,0,0
Sara Monaschi,purtroppo no,8,17742000000,17752000000,10000000,357,0,0
Sara Monaschi,ma non sarei stata una buona madre in ogni caso,8,17763600000,17783200000,19600000,358,0,0
Amedeo Cinaglia,ci vuole coraggio ad ammetterlo,8,17802000000,17816800000,14800000,359,0,1
Sara Monaschi,ce n è voluto anche per venire qui da lei oggi,8,17852800000,17878400000,25600000,360,0,0
Amedeo Cinaglia,che posso fare per lei,8,17898800000,17912400000,13600000,361,0,1
Sara Monaschi,tra le due ditte interessate ai terreni di ostia,8,17928400000,17953600000,25200000,362,0,0
Sara Monaschi,ce n è una molto compromessa,8,17954400000,17971600000,17200000,363,0,0
Sara Monaschi,e se ci guarda dentro ci troverà addirittura le mafie del sud,8,17976800000,18006800000,30000000,364,0,0
Amedeo Cinaglia,la mafia,8,18034000000,18044400000,10400000,365,0,1
Amedeo Cinaglia,a roma,8,18050400000,18060800000,10400000,366,0,1
Sara Monaschi,faccia scoppiare questo scandalo prima che sia troppo tardi,8,18061600000,18092400000,30800000,367,0,0
Amedeo Cinaglia,sta facendo un accusa molto grave,8,18111600000,18132800000,21200000,368,0,1
Amedeo Cinaglia,come fa a sapere certe cose,8,18133600000,18147200000,13600000,369,0,1
Sara Monaschi,controlli lei quella ditta,8,18156400000,18173600000,17200000,370,0,0
Sara Monaschi,sta tutto lì dentro ma lo faccia subito,8,18180400000,18205200000,24800000,371,0,0
Amedeo Cinaglia,grazie di essere venuta da me,8,18221600000,18240000000,18400000,372,0,1
Sara Monaschi,mi posso fidare di lei,8,18263200000,18282400000,19200000,373,0,0
Amedeo Cinaglia,l ha appena fatto,8,18288400000,18302800000,14400000,374,0,1
Livia Adami,aureliano,8,18721200000,18730800000,9600000,376,0,0
Livia Adami,te devi essere la donna delle pulizie vero,8,18809600000,18828800000,19200000,378,0,0
Livia Adami,no la domanda è chi sei tu,8,18873200000,18892400000,19200000,381,0,0
Livia Adami,e soprattutto che ci fai qua,8,18896800000,18914000000,17200000,382,0,0
Livia Adami,leva sta mano,8,18945600000,18958400000,12800000,384,0,0
Livia Adami,te lo dico io chi sei,8,18990800000,19004000000,13200000,385,0,0
Livia Adami,una zoccola,8,19017200000,19028400000,11200000,386,1,0
Livia Adami,e pure negra,8,19034800000,19045600000,10800000,387,1,0
Livia Adami,quindi mo prendi tutte le tue belle cosette africane di merda,8,19053200000,19085200000,32000000,388,1,0
Livia Adami,e te ne vai perché questa è casa mia,8,19086000000,19114400000,28400000,389,0,0
Livia Adami,livia,8,19176000000,19184800000,8800000,392,0,0
Livia Adami,e basta,8,19185600000,19195200000,9600000,393,0,0
Livia Adami,questo t ha detto,8,19218800000,19230400000,11600000,395,0,0
Livia Adami,e che altro t ha raccontato per portarti qua,8,19235200000,19254000000,18800000,396,0,0
Livia Adami,pure mio padre stava in fissa con le negre,8,19298400000,19322000000,23600000,398,0,0
Livia Adami,gli faceva credere chissà che,8,19331200000,19346000000,14800000,399,0,0
Livia Adami,diceva che le amava,8,19353200000,19367200000,14000000,400,0,0
Livia Adami,gli trovava pure casa,8,19373200000,19386800000,13600000,401,0,0
Livia Adami,ma sempre zoccole rimanevano,8,19394400000,19411200000,16800000,402,0,0
Livia Adami,se non le pagava non gli piaceva capisci,8,19427600000,19446800000,19200000,403,0,0
Livia Adami,e si vede che è più furbo di suo padre,8,19488800000,19510000000,21200000,405,0,0
Livia Adami,ti sta scopando gratis,8,19557600000,19574000000,16400000,406,0,0
Aureliano Adami,ahó,8,19705200000,19713600000,8400000,408,0,1
Aureliano Adami,sto a fare un favore a un amico,8,19780000000,19795600000,15600000,410,0,1
Aureliano Adami,mia sorella invece,8,19879200000,19888800000,9600000,412,0,1
Aureliano Adami,fa sempre la galoppina del samurai,8,19899600000,19921200000,21600000,413,0,1
Aureliano Adami,quanto sei bello romole,8,20091600000,20108000000,16400000,419,0,1
Aureliano Adami,il problema è che non sono tutti come te,8,20158400000,20178800000,20400000,420,0,1
Angelica Sale,mo sì che ho capito che mi dovevi dire,8,20436800000,20454000000,17200000,421,0,0
Alberto Anacleti,ahó mo ricominci,8,20460000000,20478000000,18000000,422,0,1
Angelica Sale,e no mo finisco,8,20499200000,20513200000,14000000,423,0,0
Angelica Sale,io so che sei,8,20528000000,20541599999,13599999,424,0,0
Alberto Anacleti,e che sono,8,20590000000,20599600000,9600000,425,0,1
Angelica Sale,a te le femmine non ti piacciono albe,8,20607600000,20626399999,18799999,426,0,0
Angelica Sale,ecco perché non mi tocchi,8,20627199999,20641200000,14000001,427,0,0
Angelica Sale,t ho visto oggi con l amichetto tuo,8,20651999999,20668800000,16800001,428,0,0
Angelica Sale,e mi si è illuminato tutto a partire dalla notte di nozze,8,20672399999,20701200000,28800001,429,0,0
Alberto Anacleti,che stai a dire che hai visto,8,20706000000,20721200000,15200000,430,0,1
Angelica Sale,ti piace tanto eh,8,20777199999,20790800000,13600001,431,0,0
Angelica Sale,ho visto come lo guardavi te lo stavi mangiando con gli occhi,8,20817199999,20847600000,30400001,432,0,0
Alberto Anacleti,che cazzo stai a dire eh,8,20853200000,20872399999,19199999,433,1,1
Angelica Sale,ah,8,20900400000,20909600000,9200000,434,0,0
Angelica Sale,mi basta dire tutto a manfredi e sei morto,8,20992400000,21014800000,22400000,435,0,0
Angelica Sale,ma io sono disposta pure ad andare avanti come una coppia vera,8,21019200000,21049200000,30000000,436,0,0
Alberto Anacleti,che vorresti dire,8,21060000000,21072000000,12000000,437,0,1
Angelica Sale,che ti ho sposato per diventare la principessa di sta famiglia,8,21108400000,21138800000,30400000,438,0,0
Angelica Sale,e invece sto qua a fare la sguattera,8,21144400000,21165200000,20800000,439,0,0
Angelica Sale,voglio un figlio,8,21174400000,21188400000,14000000,440,0,0
Angelica Sale,un principe senza un erede non conta un cazzo,8,21194400000,21216000000,21600000,441,1,0
Angelica Sale,io senza un erede me ne vado,8,21225600000,21243600000,18000000,442,0,0
Angelica Sale,che vuoi fare,8,21251600000,21264000000,12400000,443,0,0
Samurai Valerio,tu che ci fai qua,8,21696800000,21706800000,10000000,444,0,1
Amedeo Cinaglia,una certa monaschi è venuta da me oggi,8,21717600000,21736000000,18400000,445,0,1
Amedeo Cinaglia,dice che qualcuno ha portato la mafia a roma,8,21745200000,21765600000,20400000,446,0,1
Amedeo Cinaglia,e io dovrei aiutarla a far scoppiare lo scandalo,8,21772000000,21792400000,20400000,447,0,1
Samurai Valerio,è una matta,8,21799200000,21811600000,12400000,448,0,1
Amedeo Cinaglia,sembra pericolosa però,8,21816400000,21833600000,17200000,449,0,1
Samurai Valerio,dipende da quello che sa,8,21844000000,21858000000,14000000,450,0,1
Samurai Valerio,che sa,8,21868000000,21876400000,8400000,451,0,1
Amedeo Cinaglia,qualcuno le ha parlato,8,21895600000,21907200000,11600000,452,0,1
Amedeo Cinaglia,forse finucci,8,21924400000,21934400000,10000000,453,0,1
Samurai Valerio,può essere,8,21969200000,21979600000,10400000,454,0,1
Alberto Anacleti,ahó dove sta la roba,8,22129600000,22150000000,20400000,455,0,1
Aureliano Adami,sta qua la roba,8,22157600000,22166800000,9200000,456,0,1
Aureliano Adami,ma che hai fatto,8,22210400000,22220400000,10000000,457,0,1
Aureliano Adami,spadi che cazzo stai facendo,8,22244400000,22260800000,16400000,458,1,1
Aureliano Adami,ahó che cazzo stai facendo,8,22266000000,22302000000,36000000,459,1,1
Alberto Anacleti,lasciami stare c ho i cazzi miei,8,22266000000,22302000000,36000000,460,1,1
Aureliano Adami,guardami in faccia i cazzi tuoi li lasci fuori da qua,8,22302800000,22326800000,24000000,461,1,1
Aureliano Adami,siamo a una svolta,8,22337200000,22347200000,10000000,462,0,1
Aureliano Adami,va bene,8,22350400000,22360400000,10000000,463,0,1
Aureliano Adami,e fammi un sorriso guarda che bel cappello che hai,8,22392000000,22419600000,27600000,464,0,1
Aureliano Adami,invece di essere contento,8,22420400000,22433600000,13200000,465,0,1
Aureliano Adami,dammi sta cosa,8,22434400000,22446400000,12000000,466,0,1
Aureliano Adami,andiamo,8,22454000000,22463200000,9200000,467,0,1
Samurai Valerio,si tratta così un amico,8,22799200000,22813200000,14000000,471,0,1
Samurai Valerio,potevi venire tu allora,8,22888000000,22901200000,13200000,473,0,1
Samurai Valerio,la verità è che sarei passato pure prima,8,22974400000,22996400000,22000000,475,0,1
Samurai Valerio,ma sto invecchiando giacomi,8,22997200000,23011200000,14000000,476,0,1
Samurai Valerio,so come farti uscire da questa prigione,8,23043600000,23065200000,21600000,478,0,1
Samurai Valerio,però,8,23082000000,23091600000,9600000,479,0,1
Samurai Valerio,ti tocca andare il più lontano possibile,8,23111200000,23133200000,22000000,480,0,1
Samurai Valerio,da mo che ho smesso,8,23228000000,23240400000,12400000,482,0,1
Samurai Valerio,lascia perdere,8,23297600000,23309600000,12000000,485,0,1
Samurai Valerio,bei tempi,8,23456000000,23466400000,10400000,491,0,1
Aureliano Adami,dove cazzo sta questo,8,24057200000,24071200000,14000000,498,1,1
Alberto Anacleti,doveva arrivare alle dieci,8,24076400000,24092800001,16400001,499,0,1
Amedeo Cinaglia,ti piacciono,8,25028000000,25038000000,10000000,509,0,1
Amedeo Cinaglia,un altro,8,25423200000,25434800000,11600000,512,0,1
Aureliano Adami,va bene io mi sono rotto il cazzo,8,25496400000,25512400000,16000000,513,1,1
Alberto Anacleti,là,8,25954400000,25963200000,8800000,522,0,1
Alberto Anacleti,cazzo,8,26610800000,26622400000,11600000,529,1,1
Alberto Anacleti,ma che vuoi,8,27000000000,27016400000,16400000,531,0,1
Alberto Anacleti,io non ho fatto un cazzo,8,27019600000,27031600000,12000000,533,1,1
Aureliano Adami,andiamo,8,27221200000,27232000000,10800000,536,0,1
Livia Adami,ahó,9,101600000,110000000,8400000,1,0,0
Livia Adami,pronto,9,124800000,144400000,19600000,3,0,0
Alberto Anacleti,aurelia,9,964800000,973200000,8400000,5,0,1
Alberto Anacleti,non l hanno trovato,9,1004400000,1016000000,11600000,6,0,1
Alberto Anacleti,sto pezzo di merda sono due giorni che si nasconde,9,1040400000,1067600000,27200000,7,1,1
Alberto Anacleti,sì mo arrivo,9,1068400000,1078400000,10000000,8,0,1
Angelica Sale,il caffè è pronto,9,1124800000,1135200000,10400000,9,0,0
Alberto Anacleti,no vado di fretta,9,1136000000,1148000000,12000000,10,0,1
Angelica Sale,te lo porto di qua,9,1155600000,1166400000,10800000,11,0,0
Alberto Anacleti,ho detto che vado di fretta torna di là,9,1169600000,1191600000,22000000,12,0,1
Angelica Sale,non ci vado di là,9,1212800000,1224800000,12000000,13,0,0
Angelica Sale,aspetto la risposta a quello che ti ho chiesto ieri,9,1242000000,1265200000,23200000,14,0,0
Angelica Sale,voglio una risposta albe,9,1285600000,1300000000,14400000,15,0,0
Alberto Anacleti,vuoi una risposta,9,1309600000,1320400000,10800000,16,0,1
Alberto Anacleti,eccola,9,1338000000,1346400000,8400000,17,0,1
Aureliano Adami,ho da fare torno tardi,9,1464000000,1474800000,10800000,19,0,1
Aureliano Adami,isabel per favore non ti ci mettere pure te,9,1522400000,1544400000,22000000,22,0,1
Aureliano Adami,già ho un sacco di cazzi,9,1556000000,1569200000,13200000,23,1,1
Aureliano Adami,dimmi che è successo,9,1719200000,1730800000,11600000,25,0,1
Aureliano Adami,che cazzo ha fatto mia sorella,9,1763200000,1777200000,14000000,27,1,1
Aureliano Adami,e tu ci credi,9,1962800000,1973600000,10800000,33,0,1
Aureliano Adami,guardami,9,2152400000,2161600000,9200000,38,0,1
Aureliano Adami,guardami,9,2176800000,2185600000,8800000,39,0,1
Aureliano Adami,io voglio solo che stai bene,9,2212400000,2226000000,13600000,40,0,1
Aureliano Adami,la risolvo io questa cosa con livia va bene,9,2238000000,2258000000,20000000,41,0,1
Samurai Valerio,hai un problema li,9,2399200000,2414400000,15200000,42,0,1
Samurai Valerio,tuo fratello,9,2422000000,2431600000,9600000,43,0,1
Samurai Valerio,sta ficcando il naso in cose che non gli competono,9,2445600000,2467600000,22000000,44,0,1
Samurai Valerio,sto parlando dei miei progetti per ostia,9,2498400000,2522000000,23600000,45,0,1
Samurai Valerio,a quanto pare si sta impicciando non solo dei terreni vostri,9,2524800000,2558400000,33600000,46,0,1
Samurai Valerio,ma pure di quelli del vaticano,9,2559200000,2576800000,17600000,47,0,1
Samurai Valerio,ma ti do pure un altra brutta notizia,9,2580000000,2600000000,20000000,48,0,1
Samurai Valerio,sta ficcanasando con quell altra testa di cazzo di alberto anacleti,9,2600799999,2634000000,33200001,49,1,1
Livia Adami,ma che stai a dire,9,2634800000,2646800000,12000000,50,0,0
Samurai Valerio,ci senti bene li,9,2650000000,2662400000,12400000,51,0,1
Samurai Valerio,stanno in società tuo fratello e spadino,9,2666000000,2687600000,21600000,52,0,1
Samurai Valerio,ora io non ho tempo da perdere,9,2707600000,2722000000,14400000,53,0,1
Samurai Valerio,o la sistemi te sta cosa o ci penso io,9,2722800000,2746400000,23600000,54,0,1
Samurai Valerio,fammi sapere che decidi,9,2747200000,2759600000,12400000,55,0,1
Samurai Valerio,ricordati che con tuo padre avevo un patto,9,2804400000,2826400000,22000000,56,0,1
Amedeo Cinaglia,va bene,9,3403600000,3412000000,8400000,60,0,1
Amedeo Cinaglia,vai con mamma,9,3424400000,3442000000,17600000,62,0,1
Amedeo Cinaglia,ok ciao vittoria ciao fabrizio,9,3442800000,3470400000,27600000,64,0,1
Amedeo Cinaglia,sì,9,3517200000,3525600000,8400000,66,0,1
Amedeo Cinaglia,beh,9,3530400000,3538800000,8400000,67,0,1
Amedeo Cinaglia,sei venuta fino qui per dirmi questo,9,3543200000,3559600000,16400000,68,0,1
Amedeo Cinaglia,a volte basta la vergogna no,9,3649600000,3665200000,15600000,72,0,1
Amedeo Cinaglia,guarda che finucci si è suicidato per i cazzi suoi va bene,9,3748800000,3773200000,24400000,77,1,1
Amedeo Cinaglia,mi fa piacere che ti preoccupi tanto per me ma non ce n è bisogno,9,3822000000,3855200000,33200000,79,0,1
Amedeo Cinaglia,sono 15 pezzi,9,4042000000,4067600000,25600000,80,0,1
Livia Adami,sì sto controllando,9,4042000000,4067600000,25600000,81,0,0
Aureliano Adami,ciao li,9,4072800000,4082400000,9600000,82,0,1
Livia Adami,a posto,9,4088400000,4096800000,8400000,83,0,0
Livia Adami,sei venuto a spiegarmi perché cazzo ti sei messo a fare,9,4115200000,4139600000,24400000,84,1,0
Livia Adami,gli impicci con gli zingari sui terreni nostri,9,4140400000,4162400000,22000000,85,0,0
Aureliano Adami,no mi sa che io non ti devo spiegare proprio niente invece,9,4200800000,4226000000,25200000,86,0,1
Livia Adami,hai ragione meglio non perdere tempo con le spiegazioni,9,4236800000,4269600000,32800000,87,0,0
Livia Adami,devi solo smettere di fare tutte ste stronzate,9,4270400000,4293200000,22800000,88,1,0
Livia Adami,subito,9,4300800000,4310800000,10000000,89,0,0
Livia Adami,e tornare qua dalla famiglia tua a occuparti degli affari nostri,9,4317200000,4353200000,36000000,90,0,0
Aureliano Adami,non ci sta spazio per tutti e due qua,9,4364400000,4385200000,20800000,91,0,1
Aureliano Adami,guarda quanti siete già,9,4390800000,4402800000,12000000,92,0,1
Livia Adami,certo perché lui c ha da fare con una zoccola negra,9,4403600000,4429200000,25600000,93,1,0
Aureliano Adami,li vieni qua,9,4439600000,4449200000,9600000,94,0,1
Aureliano Adami,non t azzardare più a mettere un piede dentro casa mia,9,4496000000,4520800000,24800000,95,0,1
Aureliano Adami,non ti impicciare di quello che faccio o che non faccio,9,4533200000,4558400000,25200000,96,0,1
Aureliano Adami,perché io non prendevo ordini neanche da mio padre,9,4570400000,4592400000,22000000,97,0,1
Aureliano Adami,pensa che cazzo me ne frega di quello che dici te,9,4608400000,4632800000,24400000,98,1,1
Aureliano Adami,ricordati una cosa,9,4667600000,4679200000,11600000,99,0,1
Aureliano Adami,fino a quando respiro,9,4680000000,4694400000,14400000,100,0,1
Aureliano Adami,il chiosco mio samurai non lo deve guardare neanche da lontano,9,4711600000,4740800000,29200000,101,0,1
Aureliano Adami,ciao li,9,4863200000,4872800000,9600000,102,0,1
Aureliano Adami,levati dal cazzo,9,4932400000,4944000000,11600000,103,1,1
Sara Monaschi,l atto di rinuncia,9,5030800000,5044000000,13200000,105,0,0
Sara Monaschi,i terreni sono tuoi,9,5070400000,5083200000,12800000,106,0,0
Samurai Valerio,onore al merito,9,5088000000,5104000000,16000000,107,0,1
Samurai Valerio,ti sei battuta fino alla fine,9,5106400000,5122400000,16000000,108,0,1
Samurai Valerio,ma purtroppo per te hai sbagliato avversario,9,5133600000,5156799999,23199999,109,0,1
Sara Monaschi,mi sono messa contro uno pronto ad uccidere,9,5174400000,5197200000,22800000,110,0,0
Sara Monaschi,vuoi ammazzare anche me adesso dopo finucci,9,5239199999,5263600000,24400001,111,0,0
Samurai Valerio,le donne non si toccano neanche con un fiore,9,5280800000,5302400000,21600000,112,0,1
Livia Adami,di che stai parlando,9,5564400000,5577200000,12800000,114,0,0
Livia Adami,fammi capire,9,5782000000,5792800000,10800000,123,0,0
Livia Adami,io che dovrei fare secondo te,9,5805200000,5821600000,16400000,124,0,0
Livia Adami,ecco,9,5868800000,5887600000,18800000,126,0,0
Livia Adami,allora che,9,6178800000,6188400000,9600000,132,0,0
Livia Adami,tu non t impicciare,9,6204400000,6216800000,12400000,133,0,0
Livia Adami,sono affari nostri questi,9,6225600000,6242800000,17200000,134,0,0
Samurai Valerio,che mi devi dire cina,9,6444000000,6457200000,13200000,136,0,1
Samurai Valerio,sono stanco delle chiacchiere,9,6463200000,6477200000,14000000,137,0,1
Samurai Valerio,qua il tempo stringe non ho più voglia di sentire scuse,9,6478000000,6505200000,27200000,138,0,1
Amedeo Cinaglia,non è così semplice,9,6535200000,6547600000,12400000,139,0,1
Amedeo Cinaglia,adesso c è un morto,9,6561200000,6574800000,13600000,140,0,1
Samurai Valerio,non è roba di cui ti devi occupare tu,9,6578000000,6594000000,16000000,141,0,1
Samurai Valerio,i patti sono chiari,9,6594800000,6608000000,13200000,142,0,1
Samurai Valerio,e adesso io voglio solo risultati,9,6620800000,6640000000,19200000,143,0,1
Amedeo Cinaglia,com è morto finucci,9,6665200000,6678000000,12800000,144,0,1
Amedeo Cinaglia,perché non si è suicidato,9,6691600000,6704400000,12800000,145,0,1
Samurai Valerio,beh dovresti saperlo,9,6712400000,6724800000,12400000,146,0,1
Samurai Valerio,sei venuto tu a dirmi che finucci aveva parlato con la monaschi,9,6742800000,6773600000,30800000,147,0,1
Samurai Valerio,non fare l ingenuo,9,6785200000,6800400000,15200000,148,0,1
Samurai Valerio,quello che è successo a finucci l abbiamo fatto insieme io e te,9,6801200000,6837600000,36400000,149,0,1
Samurai Valerio,siamo complici cina,9,6848400000,6863600000,15200000,150,0,1
Samurai Valerio,soci in affari,9,6870800000,6885600000,14800000,151,0,1
Gabriele Marchilli,buongiorno,9,7154000000,7168000000,14000000,152,0,1
Aureliano Adami,ti stai a nascondere come un sorcio,9,7206400000,7225600000,19200000,154,0,1
Aureliano Adami,fai bene,9,7276800000,7285600000,8800000,155,0,1
Aureliano Adami,andiamo,9,7297600000,7306000000,8400000,156,0,1
Aureliano Adami,va di là,9,7671200000,7682000000,10800000,157,0,1
Alberto Anacleti,qua non ci sta nessuno,9,7916400000,7933200000,16800000,158,0,1
Gabriele Marchilli,mi dispiace spadi,9,7989200000,8002800000,13600000,159,0,1
Gabriele Marchilli,mi dispiace tanto,9,8003600000,8014400000,10800000,160,0,1
Aureliano Adami,lele,9,8020000000,8029200000,9200000,161,0,1
Aureliano Adami,non fare cazzate,9,8050400000,8062800000,12400000,162,1,1
Aureliano Adami,dammi sta pistola,9,8077200000,8091200000,14000000,163,0,1
Gabriele Marchilli,non ti avvicinare,9,8092000000,8102800000,10800000,164,0,1
Gabriele Marchilli,t ho detto non ti avvicinare,9,8108400000,8120400000,12000000,165,0,1
Gabriele Marchilli,tu non capisci non avevo scelta,9,8131200000,8154000000,22800000,166,0,1
Aureliano Adami,non sei capace di ammazzare nessuno dammi sta pistola,9,8154800000,8180400000,25600000,167,0,1
Gabriele Marchilli,non ti avvicinare,9,8181200000,8199600000,18400000,168,0,1
Alberto Anacleti,sparagli in faccia,9,8181200000,8199600000,18400000,169,0,1
Gabriele Marchilli,statti zitto,9,8200400000,8213600000,13200000,170,0,1
Aureliano Adami,guarda lele,9,8312400000,8323200000,10800000,172,0,1
Aureliano Adami,eh,9,8328800000,8337600000,8800000,173,0,1
Aureliano Adami,siamo amici no dammi sta pistola,9,8416400000,8438800000,22400000,174,0,1
Aureliano Adami,da,9,8462400000,8472800000,10400000,175,0,1
Alberto Anacleti,pezzo di merda,9,8518800000,8553600000,34800000,176,1,1
Alberto Anacleti,cazzo,9,8576800000,8594800000,18000000,177,1,1
Samurai Valerio,che fa livia mi manda un portavoce,9,8698400000,8726800000,28400000,178,0,1
Samurai Valerio,che sarebbe,9,8792400000,8802000000,9600000,180,0,1
Sara Monaschi,ho ceduto tutto a samurai,9,9086800000,9102800000,16000000,182,0,0
Sara Monaschi,non m interessa,9,9180000000,9191200000,11200000,185,0,0
Aureliano Adami,mia sorella non è più un problema,9,10514800000,10530800000,16000000,204,0,1
Aureliano Adami,ha capito che deve stare al posto suo,9,10545200000,10563200000,18000000,205,0,1
Aureliano Adami,io senza di te non ci voglio stare,9,10617200000,10632000000,14800000,206,0,1
Aureliano Adami,dammi un po di fiducia,9,10647200000,10660800000,13600000,207,0,1
Aureliano Adami,poi ti prometto che ti ci porto io in africa,9,10691200000,10712400000,21200000,208,0,1
Aureliano Adami,in kenya ti porto nel resort più bello del kenya,9,10718000000,10743200000,25200000,209,0,1
Aureliano Adami,va bene è uguale tanto poi alla fine qua torniamo,9,10768000000,10790400000,22400000,211,0,1
Aureliano Adami,a casa nostra,9,10814400000,10824800000,10400000,212,0,1
Samurai Valerio,dove sta tuo fratello,9,10862800000,10874400000,11600000,213,0,1
Manfredi Anacleti,che c entra mio fratello,9,10890800000,10904800000,14000000,214,0,1
Samurai Valerio,se ti vuoi allargare su ostia e non sai che fa tuo fratello parti male,9,10917600000,10949200000,31600000,215,0,1
Manfredi Anacleti,parla chiaro samura,9,10964000000,10977600000,13600000,216,0,1
Samurai Valerio,spadino sta a fare gli impicci con aureliano adami,9,10982000000,11004000000,22000000,217,0,1
Samurai Valerio,per la precisione su ostia e sui terreni che interessano a me,9,11009600000,11037200000,27600000,218,0,1
Manfredi Anacleti,ma che cazzo stai a dire con quel miserabile,9,11053200000,11077200000,24000000,219,1,1
Manfredi Anacleti,che impicci da quanto,9,11088800000,11103200000,14400000,220,0,1
Samurai Valerio,manfre,9,11109600000,11118000000,8400000,221,0,1
Samurai Valerio,non ti posso spiegare io le cose che non riesci a sapere da solo,9,11124800000,11153200000,28400000,222,0,1
Samurai Valerio,una soluzione c è,9,11162000000,11173600000,11600000,223,0,1
Samurai Valerio,una soltanto,9,11174400000,11183600000,9200000,224,0,1
Samurai Valerio,vai a prendere aureliano adami,9,11186000000,11201200000,15200000,225,0,1
Samurai Valerio,ti dico io dove e quando,9,11210800000,11222800000,12000000,226,0,1
Amedeo Cinaglia,ciao,9,11352400000,11364800000,12400000,231,0,1
Amedeo Cinaglia,scusa per stamattina,9,11454400000,11469600000,15200000,233,0,1
Amedeo Cinaglia,non lo sapevo che passava gabriella,9,11480000000,11497200000,17200000,234,0,1
Amedeo Cinaglia,ma no che non c è dell altro,9,11564800000,11587600000,22800000,237,0,1
Amedeo Cinaglia,eh,9,11783600000,11792000000,8400000,243,0,1
Amedeo Cinaglia,sono cose complicate da spiegare,9,11861600000,11878400000,16800000,245,0,1
Amedeo Cinaglia,no non c ho paura,9,11927600000,11946000000,18400000,248,0,1
Manfredi Anacleti,dove vai vieni qua,9,12819600000,12837200000,17600000,266,0,1
Alberto Anacleti,che cazzo stai facendo,9,12838000000,12852000000,14000000,267,1,1
Manfredi Anacleti,non ti devi più azzardare di fartela con aureliano adami,9,12855600000,12881600000,26000000,268,0,1
Manfredi Anacleti,ha ammazzato tuo cugino boris io questa non te la perdono spadi,9,12891600000,12926000000,34400000,269,0,1
Manfredi Anacleti,ah allora,9,12961600000,12979600000,18000000,270,0,1
Alberto Anacleti,dillo,9,13042400000,13062800000,20400000,271,0,1
Alberto Anacleti,ma non te sei visto,9,13071600000,13083200000,11600000,272,0,1
Alberto Anacleti,non sai tenere a bada tuo fratello figurati se sei buono a comandare,9,13084000000,13114400000,30400000,273,0,1
Manfredi Anacleti,che ti sei messo in testa,9,13132000000,13146800000,14800000,274,0,1
Alberto Anacleti,di farmi i cazzi miei,9,13147600000,13166800000,19200000,275,1,1
Alberto Anacleti,senza dover rendere conto a te e a sta famiglia di merda,9,13171200000,13201600000,30400000,276,1,1
Alberto Anacleti,da oggi in poi io sono un uomo libero e decido io della vita mia chiaro,9,13241600000,13274400000,32800000,277,0,1
Alberto Anacleti,saluti a tutti,9,13313200000,13327200000,14000000,278,0,1
Alberto Anacleti,spadino se ne va,9,13328000000,13343200000,15200000,279,0,1
Gabriele Marchilli,no,9,13830000000,13838400000,8400000,286,0,1
Gabriele Marchilli,non ti preoccupare,9,13849600000,13861200000,11600000,287,0,1
Gabriele Marchilli,ciao,9,14135200000,14143600000,8400000,290,0,1
Gabriele Marchilli,va bene,9,14287600000,14296000000,8400000,294,0,1
Gabriele Marchilli,no,9,14330400000,14338800000,8400000,296,0,1
Gabriele Marchilli,sei stata a casa mia,9,14490800000,14501600000,10800000,297,0,1
Gabriele Marchilli,il foulard,9,14552400000,14561200000,8800000,298,0,1
Gabriele Marchilli,l ho visto a casa mia,9,14567200000,14582000000,14800000,299,0,1
Gabriele Marchilli,stavi con mio padre,9,14609600000,14619200000,9600000,300,0,1
Gabriele Marchilli,e da quanto,9,14694400000,14702800000,8400000,302,0,1
Gabriele Marchilli,non me l ha mai detto,9,14777200000,14787200000,10000000,304,0,1
Gabriele Marchilli,era lui che non voleva che la vedessi,9,14943200000,14960400000,17200000,308,0,1
Aureliano Adami,hai saputo qualcosa,9,15442800000,15456400000,13600000,320,0,1
Aureliano Adami,si sta nascondendo sto infame,9,15470400000,15502800000,32400000,321,0,1
Alberto Anacleti,non ti preoccupare che lo troviamo,9,15470400000,15502800000,32400000,322,0,1
Alberto Anacleti,lo troviamo,9,15503600000,15512000000,8400000,323,0,1
Aureliano Adami,ma che cazzo ti ridi spadi,9,15524400000,15539200000,14800000,325,1,1
Alberto Anacleti,perché mi sono liberato di un peso non puoi capire quanto sono felice,9,15547200000,15577200000,30000000,326,0,1
Alberto Anacleti,ho mandato affanculo mio fratello,9,15578000000,15600000000,22000000,327,1,1
Aureliano Adami,e sti cazzi,9,15578000000,15600000000,22000000,328,1,1
Aureliano Adami,abbiamo ucciso una guardia e lele ce l ha buttato al culo,9,15600800000,15624800000,24000000,329,1,1
Aureliano Adami,ce lo dobbiamo togliere dal cazzo,9,15625600000,15641600000,16000000,330,1,1
Alberto Anacleti,che cazzo te ne frega,9,15650800000,15664400000,13600000,331,1,1
Alberto Anacleti,siamo nella società della monaschi mo ci prendiamo i terreni di ostia,9,15665200000,15698400000,33200000,332,0,1
Alberto Anacleti,e svoltiamo aurelia,9,15699200000,15716000000,16800000,333,0,1
Alberto Anacleti,e poi affanculo mio fratello tua sorella e affanculo pure lele,9,15719200000,15748800000,29600000,334,1,1
Aureliano Adami,sì ma sta calmo che ancora non è detto un cazzo,9,15749600000,15772000000,22400000,335,1,1
Aureliano Adami,la monaschi non si sa che sta facendo può essere che fa gli impicci con lele,9,15791200000,15824400000,33200000,336,0,1
Aureliano Adami,quindi c è poco da stare allegri,9,15825200000,15839600000,14400000,337,0,1
Aureliano Adami,abbassa sta cazzo di musica,9,15843600000,15860800000,17200000,338,1,1
Alberto Anacleti,ma quale abbassa qua ci tocca alzare,9,15861600000,15884400000,22800000,339,0,1
Alberto Anacleti,ci tocca alzare,9,15885200000,15897600000,12400000,340,0,1
Aureliano Adami,dai spadi,9,15916400000,15927200000,10800000,342,0,1
Alberto Anacleti,dai che stiamo per sfondare,9,15959600000,15984800000,25200000,343,0,1
Alberto Anacleti,ci prendiamo tutta ostia e la facciamo diventare las vegas,9,15985600000,16020400000,34800000,344,0,1
Alberto Anacleti,siamo io e te,9,16021200000,16032000000,10800000,345,0,1
Aureliano Adami,puoi fare tutto pure da solo,9,16032800000,16062800000,30000000,346,0,1
Alberto Anacleti,no in due siamo più forti,9,16032800000,16062800000,30000000,347,0,1
Alberto Anacleti,aurelia,9,16063600000,16074800000,11200000,348,0,1
Aureliano Adami,oh,9,16063600000,16074800000,11200000,349,0,1
Aureliano Adami,ma che cazzo stai facendo,9,16075600000,16092800000,17200000,350,1,1
Alberto Anacleti,oh dai stavo giocando,9,16144800000,16161200000,16400000,351,0,1
Aureliano Adami,e che gioco è,9,16213600000,16223200000,9600000,352,0,1
Aureliano Adami,eh,9,16246000000,16256800000,10800000,353,0,1
Aureliano Adami,frocio di merda che gioco è,9,16338000000,16354000000,16000000,355,1,1
Alberto Anacleti,tu mi hai cambiato la vita aurelia,9,16411200000,16429200000,18000000,357,0,1
Aureliano Adami,ma che cazzo stai dicendo,9,16469600000,16488000000,18400000,359,1,1
Aureliano Adami,a me fanno schifo quelli come te,9,16541600000,16561600000,20000000,361,0,1
Aureliano Adami,non mi toccare,9,16603200000,16617200000,14000000,363,0,1
Manfredi Anacleti,tra un po mi levo una soddisfazione,9,17464000000,17484000000,20000000,372,0,1
Angelica Sale,sono contenta per te,9,17491200000,17506000000,14800000,373,0,0
Manfredi Anacleti,te le dovresti levare pure te ogni tanto,9,17506800000,17528400000,21600000,374,0,1
Angelica Sale,e che mi tolgo,9,17531600000,17544000000,12400000,375,0,0
Angelica Sale,che non ho più neanche un marito,9,17559600000,17575600000,16000000,376,0,0
Manfredi Anacleti,spadino ritorna te lo garantisco,9,17576400000,17598400000,22000000,377,0,1
Manfredi Anacleti,per qualsiasi cosa tu fai parte della famiglia ormai,9,17601600000,17628000000,26400000,378,0,1
Manfredi Anacleti,dovresti fare un figlio per una donna è importante,9,17676800000,17702000000,25200000,379,0,1
Manfredi Anacleti,mo vedrai che arriva,9,17760800000,17774400000,13600000,380,0,1
Manfredi Anacleti,te ne facevo fare 50 di figli a te,9,17861600000,17884400000,22800000,381,0,1
Gabriele Marchilli,rivuoi le chiavi,9,18172800000,18184000000,11200000,382,0,1
Gabriele Marchilli,eccole,9,18216800000,18225200000,8400000,383,0,1
Sara Monaschi,ho saputo di tuo padre,9,18258800000,18273200000,14400000,384,0,0
Gabriele Marchilli,rischi grosso,9,18314800000,18326000000,11200000,385,0,1
Gabriele Marchilli,tuo marito è bello incazzato,9,18346400000,18359600000,13200000,386,1,1
Sara Monaschi,io volevo darti solo un abbraccio,9,18376000000,18396400000,20400000,387,0,0
Gabriele Marchilli,è da quando è morto che tutti mi abbracciano,9,18436800000,18458800000,22000000,388,0,1
Gabriele Marchilli,l ho sempre trattato come uno stronzo,9,18625600000,18648000000,22400000,389,1,1
Gabriele Marchilli,ma lo stronzo vero sono io,9,18700000000,18716400000,16400000,390,1,1
Gabriele Marchilli,non l ho mai ascoltato,9,18750800000,18762000000,11200000,391,0,1
Gabriele Marchilli,e ora non sto più in tempo per chiedergli scusa,9,18783600000,18804400000,20800000,392,0,1
Sara Monaschi,un padre non le vuole le scuse di un figlio,9,18857600000,18880400000,22800000,393,0,0
Aureliano Adami,sì,9,19099200000,19118800000,19600000,397,0,1
Aureliano Adami,a un amico mio che m ha fatto incazzare,9,19298800000,19318400000,19600000,400,1,1
Aureliano Adami,avevo ragione sì,9,19319200000,19338800000,19600000,402,0,1
Aureliano Adami,quirino che cazzo vuoi,9,19513600000,19528800000,15200000,406,1,1
Aureliano Adami,va bene,9,19571200000,19579600000,8400000,407,0,1
Aureliano Adami,l uomo di mia sorella dice che livia mi aspetta in palestra,9,19622400000,19649200000,26800000,408,0,1
Aureliano Adami,mi sbrigo,9,19688800000,19697200000,8400000,409,0,1
Aureliano Adami,dammi un bacio,9,19714800000,19726000000,11200000,410,0,1
Samurai Valerio,che vuoi,9,20028800000,20044800000,16000000,411,0,1
Amedeo Cinaglia,parlare,9,20028800000,20044800000,16000000,412,0,1
Samurai Valerio,già ci siamo detti tutto,9,20064800000,20076400000,11600000,413,0,1
Amedeo Cinaglia,non credo,9,20080400000,20090400000,10000000,414,0,1
Samurai Valerio,c ho da fare cina sbrigati,9,20106400000,20125600000,19200000,415,0,1
Amedeo Cinaglia,tu mi hai detto che una volta dentro,9,20234800000,20252000000,17200000,416,0,1
Amedeo Cinaglia,io non potevo più tornare indietro,9,20261200000,20278400000,17200000,417,0,1
Amedeo Cinaglia,io non ci torno indietro anzi,9,20292400000,20308400000,16000000,418,0,1
Amedeo Cinaglia,vado fino in fondo,9,20315600000,20329600000,14000000,419,0,1
Amedeo Cinaglia,quando una cosa va fatta va fatta bene no,9,20347600000,20367600000,20000000,420,0,1
Samurai Valerio,mi dici che vuoi,9,20379200000,20389200000,10000000,421,0,1
Amedeo Cinaglia,voglio parlare con quelli che stanno dietro di te,9,20398800000,20420000000,21200000,422,0,1
Amedeo Cinaglia,voglio incontrare la mafia,9,20437600000,20452800000,15200000,423,0,1
Samurai Valerio,e che gli vuoi dire,9,20488800000,20500800000,12000000,424,0,1
Amedeo Cinaglia,e voglio essere il loro punto di riferimento in comune,9,20524000000,20552399999,28399999,425,0,1
Samurai Valerio,rimettiti le scarpe di prima queste non ti vanno bene,9,20668400000,20695600000,27200000,426,0,1
Amedeo Cinaglia,taccon ce l ho in mano io,9,20763600000,20775200000,11600000,427,0,1
Amedeo Cinaglia,e non ha ancora firmato,9,20787199999,20802399999,15200000,428,0,1
Samurai Valerio,mi stai ricattando,9,20814400000,20825200000,10800000,429,0,1
Amedeo Cinaglia,tu lo chiami ricatto,9,20837600000,20851599999,13999999,430,0,1
Amedeo Cinaglia,io lo chiamo essere soci in affari,9,20862399999,20880800000,18400001,431,0,1
Livia Adami,e te che ci fai qua,9,20969600000,20982000000,12400000,433,0,0
Livia Adami,devo parlare con mio fratello,9,20999600000,21016000000,16400000,435,0,0
Livia Adami,ma che stai dicendo,9,21048000000,21059600000,11600000,437,0,0
Livia Adami,quanto tempo fa,9,21084400000,21095600000,11200000,440,0,0
Aureliano Adami,dove stai,9,21355600000,21365200000,9600000,443,0,1
Manfredi Anacleti,aureliano manco il caffè ci offri,9,21408400000,21439600000,31200000,444,0,1
Manfredi Anacleti,vai da quella parte,9,21468000000,21482400000,14400000,445,0,1
Aureliano Adami,zingaro di merda,9,21694800000,21705200000,10400000,447,1,1
Manfredi Anacleti,ce l ho sotto tiro,9,21730400000,21744400000,14000000,448,0,1
Livia Adami,aureliano,9,22616400000,22628000000,11600000,449,0,0
Livia Adami,aureliano,9,22642000000,22654000000,12000000,450,0,0
Livia Adami,tu solo una cosa non dovevi fare a casa mia,9,23066400000,23085200000,18800000,452,0,0
Livia Adami,torcere un capello a mio fratello,9,23094400000,23111200000,16800000,453,0,0
Livia Adami,si nasce soli e si muore soli,9,23304800000,23324400000,19600000,459,0,0
Livia Adami,lo dovresti sapere,9,23332800000,23346400000,13600000,460,0,0
Samurai Valerio,pronto,10,1677200000,1686400000,9200000,9,0,1
Samurai Valerio,stai bene mamma,10,1958800000,1968400000,9600000,12,0,1
Samurai Valerio,come osi venire in questa casa,10,2090000000,2115200000,25200000,14,0,1
Gabriele Marchilli,torna a letto è presto,10,2740400000,2754400000,14000000,25,0,1
Sara Monaschi,torno a casa,10,2760000000,2769600000,9600000,26,0,0
Gabriele Marchilli,a casa,10,2802400000,2810800000,8400000,27,0,1
Gabriele Marchilli,che vuol dire perché,10,2818400000,2838400000,20000000,28,0,1
Sara Monaschi,perché sì,10,2818400000,2838400000,20000000,29,0,0
Sara Monaschi,perché mi sento di fare così,10,2864800000,2878800000,14000000,30,0,0
Sara Monaschi,guardati lele,10,2948000000,2958800000,10800000,31,0,0
Sara Monaschi,sei solo un ragazzo,10,2969200000,2980800000,11600000,32,0,0
Gabriele Marchilli,sara ma che cazzo dici,10,2993600000,3008400000,14800000,33,1,1
Gabriele Marchilli,eri a letto con me un minuto fa,10,3017600000,3031200000,13600000,34,0,1
Sara Monaschi,sì lo so,10,3032000000,3042000000,10000000,35,0,0
Gabriele Marchilli,mi stai lasciando di nuovo,10,3052400000,3065600000,13200000,36,0,1
Sara Monaschi,è meglio così,10,3086800000,3100400000,13600000,37,0,0
Gabriele Marchilli,no,10,3106000000,3114400000,8400000,38,0,1
Gabriele Marchilli,è meglio per te solo per te,10,3119200000,3138800000,19600000,39,0,1
Gabriele Marchilli,tu sei una povera egoista del cazzo,10,3150400000,3170000000,19600000,40,1,1
Gabriele Marchilli,capace di stare soltanto con chi le fa più comodo,10,3170800000,3192400000,21600000,41,0,1
Sara Monaschi,e infatti torno da sandro,10,3197200000,3210800000,13600000,42,0,0
Sara Monaschi,solo con lui posso ottenere quello che voglio hai capito,10,3216000000,3243200000,27200000,43,0,0
Sara Monaschi,tu lo sai perché stai qui,10,3252400000,3266800000,14400000,44,0,0
Sara Monaschi,perché non hai un altro posto dove andare,10,3267600000,3286400000,18800000,45,0,0
Sara Monaschi,tu non sei meglio di me,10,3296400000,3309600000,13200000,46,0,0
Sara Monaschi,tu sei come me,10,3316400000,3328000000,11600000,47,0,0
Gabriele Marchilli,dimmi una cosa,10,3353200000,3362800000,9600000,48,0,1
Gabriele Marchilli,a me e te almeno per un attimo ci hai creduto,10,3381200000,3418000000,36800000,49,0,1
Sara Monaschi,per un attimo,10,3436800000,3448400000,11600000,50,0,0
Livia Adami,vai di là,10,3580000000,3588800000,8800000,51,0,0
Livia Adami,che sei venuto a fare,10,3604800000,3615200000,10400000,52,0,0
Samurai Valerio,ti avevo detto di risolvere il problema di tuo fratello non l hai fatto,10,3625200000,3658400000,33200000,53,0,1
Livia Adami,credi che non lo so che ti sei messo d accordo con quirino,10,3659200000,3687200000,28000000,54,0,0
Livia Adami,li hai mandati te gli zingari nella palestra di aureliano,10,3694000000,3721200000,27200000,55,0,0
Samurai Valerio,stammi a sentire perché quello che ti dico non lo ripeterò,10,3722000000,3748000000,26000000,56,0,1
Samurai Valerio,i vostri terreni entro stasera diventano miei,10,3750800000,3775200000,24400000,57,0,1
Samurai Valerio,o me li porti tu o me li vengo a prendere con la forza,10,3778800000,3802400000,23600000,58,0,1
Samurai Valerio,e stavolta mi sporco le mani,10,3829600000,3847200000,17600000,59,0,1
Aureliano Adami,svegliati,10,4106000000,4116000000,10000000,61,0,1
Aureliano Adami,guardami sta ferma qua,10,4116800000,4131600000,14800000,62,0,1
Aureliano Adami,fa come t ho detto,10,4137600000,4158000000,20400000,64,0,1
Aureliano Adami,siete venuti a finire il lavoro,10,4322000000,4339200000,17200000,65,0,1
Aureliano Adami,mo vediamo,10,4434400000,4443600000,9200000,69,0,1
Gabriele Marchilli,ciao,10,4554800000,4563200000,8400000,70,0,1
Gabriele Marchilli,che ci fai qui,10,4574800000,4585600000,10800000,71,0,1
Gabriele Marchilli,ho già detto tutto quello che so ai tuoi colleghi,10,4660400000,4684000000,23600000,74,0,1
Gabriele Marchilli,guarda mi sarà sfuggito,10,4770400000,4784800000,14400000,77,0,1
Gabriele Marchilli,non lo so non sono lucido,10,4811600000,4828000000,16400000,78,0,1
Gabriele Marchilli,ho bisogno di stare un po da solo,10,4846800000,4864800000,18000000,79,0,1
Gabriele Marchilli,sì dammi solo qualche giorno,10,4895600000,4912800000,17200000,81,0,1
Gabriele Marchilli,ciao,10,4918800000,4927200000,8400000,82,0,1
Livia Adami,come stai,10,5201599999,5211599999,10000000,83,0,0
Aureliano Adami,dove sta quell infame,10,5231599999,5244800000,13200001,84,0,1
Livia Adami,se n è andato per sempre,10,5272400000,5288400000,16000000,85,0,0
Aureliano Adami,hai visto una cosa buona alla fine sei riuscita a farla,10,5346400000,5375600000,29200000,86,0,1
Aureliano Adami,dimmi che vuoi,10,5396000000,5405600000,9600000,87,0,1
Livia Adami,il chiosco di mamma,10,5433200000,5446400000,13200000,88,0,0
Livia Adami,ci volevi fare una cosa tua,10,5452400000,5466800000,14400000,89,0,0
Livia Adami,una cosa bella,10,5470800000,5482000000,11200000,90,0,0
Livia Adami,mo sta cosa bella si può fare la possiamo fare io e te,10,5489200000,5514400000,25200000,91,0,0
Aureliano Adami,io e te,10,5520400000,5528800000,8400000,92,0,1
Aureliano Adami,e samurai,10,5558800000,5571200000,12400000,93,0,1
Livia Adami,samurai si è già preso i terreni del vaticano,10,5593600000,5616400000,22800000,94,0,0
Livia Adami,ma gli manca il nostro,10,5629200000,5642800000,13600000,95,0,0
Aureliano Adami,ma che cazzo stai dicendo,10,5643600000,5656800000,13200000,96,1,1
Livia Adami,ti dico che se li è presi,10,5675200000,5690400000,15200000,97,0,0
Livia Adami,pensavi davvero di fregarlo,10,5697600000,5716800000,19200000,98,0,0
Livia Adami,mo vuole quello che gli ha promesso papà,10,5731600000,5750400000,18800000,99,0,0
Livia Adami,questa è casa nostra aurelia non comanda samurai comandiamo noi,10,5751200000,5788800000,37600000,100,0,0
Livia Adami,e ci tocca ricordarglielo,10,5796400000,5812000000,15600000,101,0,0
Livia Adami,lo vuoi togliere di mezzo,10,5846400000,5860000000,13600000,102,0,0
Livia Adami,torna a casa,10,5866400000,5879200000,12800000,103,0,0
Livia Adami,a me e a te insieme non ci ferma neanche il diavolo,10,5885600000,5909200000,23600000,104,0,0
Aureliano Adami,ha un prezzo sta cosa vero,10,5965200000,5980400000,15200000,105,0,1
Livia Adami,in questa famiglia c è spazio solo per me e per te,10,5987200000,6016000000,28800000,106,0,0
Livia Adami,devi mandare via la negra per sempre,10,6020400000,6044000000,23600000,107,1,0
Livia Adami,io e te aurelia,10,6055600000,6067600000,12000000,108,0,0
Livia Adami,solo io e te,10,6075600000,6088400000,12800000,109,0,0
Livia Adami,pensaci,10,6180000000,6190400000,10400000,110,0,0
Samurai Valerio,devi far firmare la delibera a taccon lo devi fare oggi,10,6294400000,6328800000,34400000,111,0,1
Samurai Valerio,perché domani il sindaco se ne va,10,6331600000,6346000000,14400000,112,0,1
Samurai Valerio,e allora i giochi saranno finiti,10,6346800000,6362000000,15200000,113,0,1
Samurai Valerio,e avremmo fatto tutto per niente e questo non può essere,10,6362800000,6390400000,27600000,114,0,1
Amedeo Cinaglia,e quello che ti ho chiesto,10,6391200000,6403600000,12400000,115,0,1
Samurai Valerio,prima la firma poi quello che hai chiesto,10,6404400000,6425600000,21200000,116,0,1
Amedeo Cinaglia,dopo la firma io non ti servo a niente,10,6426400000,6444000000,17600000,117,0,1
Amedeo Cinaglia,perché dovrei fidarmi,10,6450800000,6462000000,11200000,118,0,1
Samurai Valerio,perché non hai alternative,10,6465200000,6479200000,14000000,119,0,1
Alberto Anacleti,ma che cazzo è,10,6805200000,6817600000,12400000,124,1,1
Alberto Anacleti,c è qualche problema,10,7126800000,7154000000,27200000,131,0,1
Alberto Anacleti,facile prendersela con due ragazzini due zingarelli prenditela con me,10,7159200000,7196000000,36800000,132,0,1
Alberto Anacleti,che c è non avete mai visto uno zingaro incazzato,10,7214400000,7238000000,23600000,133,1,1
Alberto Anacleti,vattene a casa va,10,7265600000,7278800000,13200000,134,0,1
Sara Monaschi,è finita,10,7396800000,7407600000,10800000,135,0,0
Sara Monaschi,l ho lasciato,10,7422400000,7432000000,9600000,136,0,0
Sara Monaschi,io voglio stare con te,10,7479600000,7492400000,12800000,137,0,0
Aureliano Adami,buongiorno,10,7513200000,7530800000,17600000,140,0,1
Sara Monaschi,è tutto a posto anna vada pure,10,7536800000,7559200000,22400000,141,0,0
Aureliano Adami,samurai s è preso i terreni del vaticano,10,7578400000,7598000000,19600000,142,0,1
Aureliano Adami,che cazzo hai fatto mona,10,7611200000,7638800000,27600000,143,1,1
Sara Monaschi,gli ho dovuto cedere tutto,10,7611200000,7638800000,27600000,144,0,0
Sara Monaschi,non avevo scelta,10,7643600000,7656400000,12800000,145,0,0
Aureliano Adami,ci hai tradito con samurai,10,7664400000,7681600000,17200000,146,0,1
Aureliano Adami,ma che cazzo ti dice il cervello,10,7692800000,7714800000,22000000,147,1,1
Sara Monaschi,mi hanno incastrata,10,7718000000,7729600000,11600000,148,0,0
Aureliano Adami,e che cazzo me ne frega a me,10,7739600000,7758800000,19200000,149,1,1
Sara Monaschi,ero sotto ricatto,10,7762400000,7773200000,10800000,150,0,0
Aureliano Adami,tu mi chiamavi mi dicevi il problema e io lo risolvevo,10,7774000000,7806000000,32000000,151,0,1
Aureliano Adami,invece adesso come cazzo fai,10,7815200000,7844800000,29600000,152,1,1
Aureliano Adami,ma chi è questo,10,7848800000,7867200000,18400000,154,0,1
Sara Monaschi,stai calmo,10,7848800000,7867200000,18400000,155,0,0
Sara Monaschi,è mio marito,10,7868000000,7876800000,8800000,156,0,0
Aureliano Adami,con sto coglione stavi ti credo che gli mettevi le corna,10,7877600000,7904800000,27200000,157,1,1
Aureliano Adami,ma chi cazzo chiami,10,7915600000,7931600000,16000000,159,1,1
Aureliano Adami,chi chiami,10,7932400000,7941600000,9200000,160,0,1
Sara Monaschi,lascialo,10,7951600000,7960000000,8400000,161,0,0
Aureliano Adami,che gli dici siete più banditi di me,10,7960800000,7978800000,18000000,162,0,1
Sara Monaschi,lascialo,10,7986400000,7996000000,9600000,163,0,0
Aureliano Adami,in campana mona,10,8070000000,8083600000,13600000,164,1,1
Sara Monaschi,mi dispiace,10,8202800000,8212800000,10000000,165,0,0
Alberto Anacleti,ciao mamma,10,8431600000,8441200000,9600000,168,0,1
Alberto Anacleti,basta,10,8508800000,8519600000,10800000,171,0,1
Alberto Anacleti,ora lasciaci soli,10,8535600000,8549200000,13600000,172,0,1
Alberto Anacleti,parliamo dopo,10,8576400000,8588000000,11600000,173,0,1
Alberto Anacleti,come sta mio fratello,10,8750400000,8761600000,11200000,175,0,1
Angelica Sale,ancora non si sa,10,8762400000,8774000000,11600000,176,0,0
Angelica Sale,e te perché sei tornato che vuoi,10,8778800000,8794800000,16000000,177,0,0
Alberto Anacleti,perché questa è casa mia e tu sei mia moglie,10,8798800000,8817200000,18400000,178,0,1
Angelica Sale,e che vuol dire,10,8818000000,8828800000,10800000,179,0,0
Alberto Anacleti,vuoi diventare la principessa di sta famiglia,10,8842400000,8863600000,21200000,180,0,1
Alberto Anacleti,facciamo quello che dobbiamo,10,8875600000,8888400000,12800000,181,0,1
Angelica Sale,lascia fare a me albe,10,9064800000,9078400000,13600000,182,0,0
Angelica Sale,chiudi gli occhi,10,9290800000,9301600000,10800000,183,0,0
Angelica Sale,chiudili,10,9497600000,9507200000,9600000,185,0,0
Aureliano Adami,te ne devi andare,10,9625200000,9636800000,11600000,186,0,1
Aureliano Adami,prepara le cose tue ci sta romolo fuori ti riporta a casa,10,9678400000,9704800000,26400000,188,0,1
Aureliano Adami,torno a casa mia non c è posto per te,10,9710000000,9736400000,26400000,190,0,1
Aureliano Adami,io non prendo ordini da nessuno,10,9846000000,9860000000,14000000,193,0,1
Amedeo Cinaglia,con la presente delibera numero 201,10,10067600000,10088000000,20400000,200,0,1
Amedeo Cinaglia,la commissione approva l unificazione del lotto 405,10,10088800000,10119200000,30400000,201,0,1
Amedeo Cinaglia,con il lotto 411,10,10120000000,10150000000,30000000,202,0,1
Amedeo Cinaglia,l appalto sull area viene attribuito alla società specchio azzurro,10,10150800000,10184800000,34000000,203,0,1
Amedeo Cinaglia,dott taccon manca solo la sua ratifica sull atto,10,10194000000,10228400000,34400000,204,0,1
Amedeo Cinaglia,dottore,10,10352400000,10361600000,9200000,206,0,1
Amedeo Cinaglia,scusate,10,10392400000,10402000000,9600000,207,0,1
Amedeo Cinaglia,qual è il problema,10,10643600000,10656000000,12400000,210,0,1
Amedeo Cinaglia,taccon per favore nessuno potrà mai contestarle nulla,10,10702000000,10738400000,36400000,212,0,1
Amedeo Cinaglia,glielo garantisco,10,10744000000,10755200000,11200000,213,0,1
Amedeo Cinaglia,pensi a lei al suo futuro lontano da qui,10,10768400000,10792800000,24400000,214,0,1
Amedeo Cinaglia,firmi quell atto,10,10793600000,10804800000,11200000,215,0,1
Amedeo Cinaglia,andranno a dei costruttori né meglio né peggio di altri,10,10836800000,10865600000,28800000,217,0,1
Amedeo Cinaglia,ma guardi al risultato,10,10886000000,10899200000,13200000,218,0,1
Amedeo Cinaglia,ostia avrà un porto,10,10900000000,10914800000,14800000,219,0,1
Amedeo Cinaglia,lavoro sviluppo la città si muove va avanti,10,10915600000,10944800000,29200000,220,0,1
Amedeo Cinaglia,ormai sei dentro,10,11008400000,11020000000,11600000,223,0,1
Amedeo Cinaglia,ti credi così furbo da poterti tirare indietro,10,11044400000,11072800000,28400000,224,1,1
Amedeo Cinaglia,a me non sembri furbo,10,11102400000,11118000000,15600000,225,0,1
Amedeo Cinaglia,per niente,10,11134800000,11145600000,10800000,226,0,1
Amedeo Cinaglia,finucci,10,11172800000,11184400000,11600000,227,0,1
Amedeo Cinaglia,finucci era furbo,10,11187200000,11201200000,14000000,228,0,1
Amedeo Cinaglia,guarda che fine ha fatto,10,11207200000,11222000000,14800000,229,0,1
Amedeo Cinaglia,firma quelle carte fidati,10,11298000000,11321600000,23600000,230,0,1
Amedeo Cinaglia,come un pupo,10,11369200000,11379200000,10000000,232,0,1
Amedeo Cinaglia,è meglio andare,10,11414000000,11424400000,10400000,233,0,1
Amedeo Cinaglia,bene,10,11840800000,11850400000,9600000,234,0,1
Livia Adami,beh,10,11973200000,11982400000,9200000,235,0,0
Aureliano Adami,ho risolto,10,12030000000,12040800000,10800000,236,0,1
Livia Adami,come stai,10,12149200000,12160000000,10800000,237,0,0
Aureliano Adami,quando ti vedi con samurai,10,12172800000,12185600000,12800000,238,0,1
Livia Adami,stasera mo dico a romolo di organizzare,10,12214400000,12232000000,17600000,239,0,0
Aureliano Adami,no organizzo io,10,12232800000,12247200000,14400000,240,0,1
Livia Adami,tu non ci devi andare,10,12248000000,12280000000,32000000,241,0,0
Aureliano Adami,io faccio quello che cazzo mi pare,10,12248000000,12280000000,32000000,242,1,1
Livia Adami,va bene,10,12300000000,12308400000,8400000,243,0,0
Livia Adami,sono contenta che stai qua,10,12351200000,12364400000,13200000,244,0,0
Amedeo Cinaglia,è la seconda volta che vieni sotto casa mia,10,12598000000,12618400000,20400000,245,0,1
Amedeo Cinaglia,che vuoi,10,12638800000,12648400000,9600000,246,0,1
Amedeo Cinaglia,no,10,12662000000,12670400000,8400000,247,0,1
Amedeo Cinaglia,ho smesso,10,12674800000,12684800000,10000000,248,0,1
Amedeo Cinaglia,lo immaginavo,10,12768000000,12778800000,10800000,252,0,1
Amedeo Cinaglia,no ho altri programmi,10,12802000000,12822000000,20000000,254,0,1
Amedeo Cinaglia,mi hai detto quello che volevi dirmi,10,12886800000,12904800000,18000000,256,0,1
Amedeo Cinaglia,e allora perché sei ancora qui,10,12924000000,12939200000,15200000,257,0,1
Amedeo Cinaglia,io lo so perché stai ancora qua,10,12996800000,13012000000,15200000,258,0,1
Amedeo Cinaglia,perché sono cambiato,10,13034000000,13045200000,11200000,259,0,1
Amedeo Cinaglia,e adesso mi vuoi,10,13062800000,13075600000,12800000,260,0,1
Amedeo Cinaglia,dovresti smettere anche tu,10,13174000000,13188800000,14800000,261,0,1
Amedeo Cinaglia,ti fanno male,10,13192000000,13202400000,10400000,262,0,1
Aureliano Adami,siamo pronti romole,10,13332800000,13344000000,11200000,263,0,1
Livia Adami,vengo pure io,10,13372400000,13380800000,8400000,265,0,0
Aureliano Adami,no mi serve che vai a casa,10,13426400000,13442800000,16400000,266,0,1
Aureliano Adami,chiama quel pezzo di merda e digli che stai arrivando con i documenti firmati,10,13465600000,13501200000,35600000,267,1,1
Livia Adami,andiamo,10,13528800000,13538400000,9600000,268,0,0
Samurai Valerio,va bene,10,13788800000,13799200000,10400000,270,0,1
Samurai Valerio,era livia,10,13826800000,13836800000,10000000,271,0,1
Samurai Valerio,tutto a posto,10,13841600000,13851600000,10000000,272,0,1
Amedeo Cinaglia,ho fatto come mi hai detto tu,10,13942400000,13956400000,14000000,274,0,1
Amedeo Cinaglia,credo di sì,10,14042400000,14052000000,9600000,276,0,1
Samurai Valerio,credevo venissi da solo,10,14480400000,14496800000,16400000,280,0,1
Aureliano Adami,e invece mi piace girare in compagnia,10,14503600000,14524000000,20400000,281,0,1
Samurai Valerio,che vuoi,10,14537600000,14547600000,10000000,282,0,1
Aureliano Adami,a ostia mo comando io,10,14585200000,14600000000,14800000,283,0,1
Aureliano Adami,quindi se vuoi fare impicci li fai con me,10,14614800000,14634000000,19200000,284,0,1
Aureliano Adami,se no non li fai per niente,10,14634800000,14648800000,14000000,285,0,1
Samurai Valerio,il ragazzo si è fatto uomo,10,14659600000,14676800000,17200000,286,0,1
Aureliano Adami,te ti sei invecchiato invece,10,14685200000,14704000000,18800000,287,0,1
Aureliano Adami,forse è ora che ti levi dal cazzo samura,10,14716400000,14737600000,21200000,288,1,1
Samurai Valerio,dici,10,14750400000,14758800000,8400000,289,0,1
Samurai Valerio,mi credevi così coglione da non immaginare quello che avresti fatto,10,14864400000,14898800000,34400000,291,1,1
Samurai Valerio,io non ho paura di morire,10,14916800000,14929200000,12400000,292,0,1
Samurai Valerio,tu,10,14932400000,14941200000,8800000,293,0,1
Samurai Valerio,vuoi prendere il posto di livia e stare nell affare,10,14958800000,14984800000,26000000,294,0,1
Samurai Valerio,va bene ti tengo dentro,10,14989600000,15007600000,18000000,295,0,1
Samurai Valerio,farai parte della quota mia,10,15008400000,15022400000,14000000,296,0,1
Samurai Valerio,manco a tuo padre gli davo tanto,10,15023200000,15039600000,16400000,297,0,1
Samurai Valerio,ma i tempi sono cambiati,10,15057600000,15072000000,14400000,298,0,1
Samurai Valerio,bisogna dare spazio ai giovani,10,15077200000,15093600000,16400000,299,0,1
Samurai Valerio,salutami tua sorella,10,15180000000,15193200000,13200000,300,0,1
Aureliano Adami,andate via,10,16079200000,16088400000,9200000,310,0,1
Aureliano Adami,prendi sti soldi e vattene,10,16374000000,16389600000,15600000,311,0,1
Livia Adami,ma che stai dicendo aurelia,10,16414400000,16429200000,14800000,312,0,0
Aureliano Adami,non mi toccare,10,16466800000,16477600000,10800000,313,0,1
Aureliano Adami,non mi devi toccare,10,16503600000,16518000000,14400000,314,0,1
Livia Adami,di quando sei nato mi ricordo papà che dice,10,16563600000,16586000000,22400000,315,0,0
Livia Adami,mamma non c è più,10,16597200000,16612000000,14800000,316,0,0
Livia Adami,a te t avevano messo in una cameretta,10,16630400000,16652000000,21600000,317,0,0
Livia Adami,e piangevi,10,16677200000,16688400000,11200000,318,0,0
Livia Adami,piangevi,10,16721600000,16733200000,11600000,319,0,0
Livia Adami,ancora me lo ricordo quel pianto,10,16750000000,16766800000,16800000,320,0,0
Livia Adami,allora io ho preso un cuscino,10,16805600000,16823600000,18000000,321,0,0
Livia Adami,perché non lo volevo sentire più quel pianto,10,16830000000,16855200000,25200000,322,0,0
Livia Adami,e poi t ho visto,10,16885200000,16896800000,11600000,323,0,0
Livia Adami,eri uno scricciolo,10,16924000000,16936800000,12800000,324,0,0
Livia Adami,allora ti ho preso in braccio,10,16962800000,16979600000,16800000,325,0,0
Livia Adami,e tu hai smesso di piangere,10,16988800000,17004400000,15600000,326,0,0
Livia Adami,mamma non c era più ma c eri tu,10,17043200000,17063600000,20400000,327,0,0
Livia Adami,mio fratello,10,17090400000,17100800000,10400000,328,0,0
Livia Adami,non mi puoi fare questo aurelia,10,17123600000,17140000000,16400000,329,0,0
Livia Adami,guardami,10,17169600000,17190000000,20400000,330,0,0
Aureliano Adami,prendi sti soldi e vattene,10,17169600000,17190000000,20400000,331,0,1
Livia Adami,tutto questo per quella negra,10,17217200000,17234000000,16800000,332,1,0
Aureliano Adami,vattene,10,17259200000,17268800000,9600000,333,0,1
Alberto Anacleti,tutto quello che ha fatto mio fratello l ha fatto per noi,10,17913600000,17940000000,26400000,336,0,1
Alberto Anacleti,per sta famiglia,10,17951200000,17964000000,12800000,337,0,1
Alberto Anacleti,perché tutti a roma ci portassero rispetto,10,17968800000,17991600000,22800000,338,0,1
Alberto Anacleti,e nessuno ci trattasse più da zingari di merda,10,18003200000,18027600000,24400000,339,1,1
Alberto Anacleti,solo che lui adesso è piantonato all ospedale e aldo è morto,10,18046800000,18078800000,32000000,340,0,1
Alberto Anacleti,adesso comando io in questa famiglia,10,18096800000,18127600000,30800000,341,0,1
Alberto Anacleti,nessuno ci deve più mancare di rispetto,10,18145200000,18173600000,28400000,342,0,1
Alberto Anacleti,ho una cosa in mente,10,18251200000,18269600000,18400000,344,0,1
Samurai Valerio,ti piace guardarla dall alto,10,18454000000,18470800000,16800000,346,0,1
Amedeo Cinaglia,mi piace guardarla da qua,10,18505600000,18524400000,18800000,347,0,1
Samurai Valerio,non devi dimenticarti da dove vieni,10,18556000000,18575200000,19200000,348,0,1
Samurai Valerio,soprattutto quando non sai ancora dove stai andando,10,18586800000,18611600000,24800000,349,0,1
Amedeo Cinaglia,so esattamente dove sto andando,10,18620400000,18636400000,16000000,350,0,1
Samurai Valerio,e dove,10,18648000000,18657600000,9600000,351,0,1
Amedeo Cinaglia,io non sarò mai il sindaco di questa città,10,18679200000,18700400000,21200000,352,0,1
Amedeo Cinaglia,non sarò mai un politico di primo livello,10,18711600000,18733600000,22000000,353,0,1
Amedeo Cinaglia,uno di quelli che vanno in televisione,10,18738800000,18757200000,18400000,354,0,1
Amedeo Cinaglia,il mio destino è stare dietro le quinte,10,18766800000,18787200000,20400000,355,0,1
Amedeo Cinaglia,esattamente come te,10,18792000000,18802000000,10000000,356,0,1
Samurai Valerio,io roma la governo,10,18842800000,18862000000,19200000,357,0,1
Amedeo Cinaglia,roma non si governa,10,18895600000,18910000000,14400000,358,0,1
Amedeo Cinaglia,al massimo si amministra,10,18916400000,18934800000,18400000,359,0,1
Amedeo Cinaglia,tu sei il mondo di mezzo,10,18935600000,18950800000,15200000,360,0,1
Amedeo Cinaglia,il luogo dove gli interessi si incontrano quelli leciti quelli illeciti,10,18956800000,18994400000,37600000,361,0,1
Amedeo Cinaglia,di fatto sei l amministratore di roma,10,19026000000,19045600000,19600000,362,0,1
Amedeo Cinaglia,non il re,10,19051200000,19064000000,12800000,363,0,1
Samurai Valerio,e tu chi saresti,10,19071200000,19083600000,12400000,364,0,1
Amedeo Cinaglia,il tuo socio,10,19088400000,19101200000,12800000,365,0,1
Samurai Valerio,non ti rilassare troppo allora,10,19165200000,19183200000,18000000,366,0,1
Samurai Valerio,abbiamo solo tre mesi per far eleggere il sindaco che vogliamo noi,10,19188000000,19221600000,33600000,367,0,1
Amedeo Cinaglia,salve,10,19345600000,19355600000,10000000,368,0,1
Samurai Valerio,accomodiamoci,10,19365200000,19375200000,10000000,369,0,1
Sara Monaschi,eminenza,10,19467200000,19485600000,18400000,371,0,0
Sara Monaschi,bene,10,19499600000,19519600000,20000000,373,0,0
Sara Monaschi,le manda i suoi saluti,10,19523200000,19544400000,21200000,374,0,0
Sara Monaschi,sì lo so ma dopo la tragedia di monsignor theodosiou,10,19617200000,19650800000,33600000,378,0,0
Sara Monaschi,ho capito che dovevo fare di più che ho bisogno di fare di più,10,19658000000,19697600000,39600000,379,0,0
Sara Monaschi,e vorrei dedicare le mie capacità,10,19705200000,19727200000,22000000,380,0,0
Sara Monaschi,a coloro che oggi hanno più bisogno agli ultimi,10,19728000000,19759600000,31600000,381,0,0
Sara Monaschi,sì,10,19782800000,19791200000,8400000,383,0,0
Sara Monaschi,le nostre città sono sempre più piene di uomini in cerca di una speranza,10,19793600000,19833600000,40000000,384,0,0
Sara Monaschi,di migranti che hanno abbandonato tutto per venire qui da noi,10,19847600000,19882800000,35200000,385,0,0
Sara Monaschi,e io penso di poterli aiutare,10,19891200000,19909200000,18000000,386,0,0
Aureliano Adami,doveva sembrare vero,10,20534800000,20547600000,12800000,398,0,1
Aureliano Adami,non ti potevo dire la verità,10,20560800000,20574800000,14000000,399,0,1
Aureliano Adami,ti volevo proteggere da livia,10,20588400000,20603600000,15200000,400,0,1
Aureliano Adami,ti voglio con me solo questo voglio,10,20740800000,20759600000,18800000,402,0,1
Contessa Sveva Della Rocca Croce,buongiorno,10,21033200000,21042800000,9600000,403,0,0
Sara Monaschi,sono passata a ringraziarla,10,21043600000,21057200000,13600000,404,0,0
Contessa Sveva Della Rocca Croce,ringraziarmi,10,21058000000,21074400000,16400000,405,0,0
Sara Monaschi,sì,10,21058000000,21074400000,16400000,406,0,0
Sara Monaschi,ho imparato molto da lei,10,21075200000,21094000000,18800000,407,0,0
Sara Monaschi,a non cedere ai sentimenti,10,21100400000,21115200000,14800000,408,0,0
Sara Monaschi,a guardarmi le spalle,10,21116000000,21130400000,14400000,409,0,0
Sara Monaschi,ma soprattutto a conservare l odio per persone che ti hanno fatto del male,10,21131200000,21172000000,40800000,410,0,0
Sara Monaschi,una lezione che non dimenticherò,10,21193200000,21210800000,17600000,411,0,0
Contessa Sveva Della Rocca Croce,stia bene,10,21219600000,21228000000,8400000,412,0,0
Sara Monaschi,ah,10,21247200000,21255600000,8400000,413,0,0
Sara Monaschi,un altra cosa ho imparato da lei,10,21262000000,21278800000,16800000,414,0,0
Sara Monaschi,a volere bene ai poveri,10,21281200000,21296400000,15200000,415,0,0
Amedeo Cinaglia,quale delle tante,10,21972400000,21981200000,8800000,421,0,1
Amedeo Cinaglia,me ne starò seduto lì dentro al mio posto,10,22092000000,22115600000,23600000,427,0,1
Amedeo Cinaglia,come sempre,10,22118400000,22127600000,9200000,428,0,1
Amedeo Cinaglia,mi candido con una mia lista,10,22152800000,22169200000,16400000,430,0,1
Amedeo Cinaglia,sindaco no,10,22218400000,22235200000,16800000,434,0,1
Amedeo Cinaglia,corro per qualcosa di molto meglio,10,22242000000,22259600000,17600000,435,0,1
Aureliano Adami,ho da fare una cosa,10,22420400000,22432400000,12000000,436,0,1
Aureliano Adami,ci vediamo dopo,10,22480800000,22494400000,13600000,437,0,1
Angelica Sale,te ne vai,10,22651600000,22661600000,10000000,438,0,0
Alberto Anacleti,devo vedere una persona,10,22670400000,22684400000,14000000,439,0,1
Alberto Anacleti,aspettatemi fuori,10,22850800000,22864000000,13200000,441,0,1
Alberto Anacleti,che cosa intendi,10,22982800000,22997200000,14400000,444,0,1
Gabriele Marchilli,non ora,10,23386000000,23394400000,8400000,453,0,1
Gabriele Marchilli,devo fare una cosa che non posso più rimandare,10,23404400000,23423600000,19200000,454,0,1
Gabriele Marchilli,mara,10,23474400000,23483600000,9200000,455,0,1
Gabriele Marchilli,ti devo parlare,10,23534400000,23546400000,12000000,456,0,1
Gabriele Marchilli,è importante,10,23554400000,23563600000,9200000,457,0,1
Gabriele Marchilli,fammi sapere tu,10,23629600000,23638000000,8400000,461,0,1
Gabriele Marchilli,a dopo,10,23674000000,23682400000,8400000,464,0,1
Alberto Anacleti,per farli felici ti dovrei ammazzare,10,24263600000,24282800000,19200000,465,0,1
Alberto Anacleti,per fargli vedere chi sono,10,24292800000,24307200000,14400000,466,0,1
Alberto Anacleti,ma io non ho bisogno di ammazzarti per capire chi sono,10,24326000000,24351600000,25600000,467,0,1
Alberto Anacleti,non ho niente da dimostrare a nessuno nemmeno a te,10,24365200000,24390000000,24800000,468,0,1
Aureliano Adami,e chi sei spadi,10,24411200000,24423600000,12400000,469,0,1
Aureliano Adami,uno zingaro di merda,10,24440800000,24455600000,14800000,470,1,1
Aureliano Adami,zingaro e frocio,10,24470400000,24486000000,15600000,471,1,1
Alberto Anacleti,però mo a casa mia comando io,10,24505600000,24523600000,18000000,472,0,1
Alberto Anacleti,la musica cambia,10,24537600000,24553600000,16000000,473,0,1
Aureliano Adami,alla fine comandiamo noi hai visto,10,24580400000,24597600000,17200000,474,0,1
Aureliano Adami,l affare con samurai lo faccio da solo però,10,24697600000,24718400000,20800000,475,0,1
Aureliano Adami,non c è posto per te,10,24738800000,24752000000,13200000,476,0,1
Alberto Anacleti,questo non lo decidi né te né samurai,10,24763600000,24783200000,19600000,477,0,1
Alberto Anacleti,tienilo a mente aurelia,10,24808400000,24824400000,16000000,478,0,1
Alberto Anacleti,magari un giorno cambi idea,10,24831600000,24846800000,15200000,479,0,1
Alberto Anacleti,e ti ricordi chi sono gli amici veri,10,24853200000,24872000000,18800000,480,0,1
Alberto Anacleti,altrimenti la prossima volta ti devo ammazzare,10,24888400000,24912000000,23600000,481,0,1
Aureliano Adami,la prossima volta spadi,10,25144800000,25160000000,15200000,482,0,1
Gabriele Marchilli,sono andato da papà e gli ho raccontato tutto,10,25311600000,25332400000,20800000,483,0,1
Gabriele Marchilli,dov era l appuntamento com erano fatti i due ragazzi,10,25340800000,25371200000,30400000,484,0,1
Gabriele Marchilli,no,10,25432400000,25440800000,8400000,486,0,1
Gabriele Marchilli,c è un altra cosa,10,25499600000,25512000000,12400000,488,0,1
Gabriele Marchilli,aveva ragione papà,10,25568800000,25580400000,11600000,490,0,1
Gabriele Marchilli,voglio entrare in polizia,10,25636000000,25651200000,15200000,492,0,1
Gabriele Marchilli,ma non lo faccio per lui,10,25709600000,25721600000,12000000,494,0,1
Gabriele Marchilli,lo faccio per me,10,25740000000,25749600000,9600000,495,0,1
Gabriele Marchilli,ma ho bisogno che mi aiuti,10,25778800000,25792400000,13600000,496,0,1
Gabriele Marchilli,grazie,10,25886400000,25896000000,9600000,498,0,1
Livia Adami,devo solo prendere le cose mie,10,26022800000,26039200000,16400000,500,0,0
Livia Adami,poi me ne vado per sempre,10,26040000000,26054000000,14000000,501,0,0
Livia Adami,romole eh,10,26622000000,26639600000,17600000,506,0,0
Livia Adami,dove cazzo sta la negra,10,26709200000,26724400000,15200000,509,1,0
Livia Adami,eh,10,26740000000,26759200000,19200000,510,0,0
Livia Adami,va là sbrigati,10,26760000000,26771600000,11600000,512,0,0
Livia Adami,tanto me la trovo da sola non ti preoccupare,10,26803200000,26824000000,20800000,513,0,0
Alberto Anacleti,sali,10,27613200000,27622800000,9600000,541,0,1
Alberto Anacleti,dai sali,10,27645200000,27658400000,13200000,542,0,1
